	unkn	[при.расшифровке:
-dū	unkn	DATLOC
-n	unkn	NMLZ
-śi	unkn	ATR
3SG.SLIP	SLIP	SLIP
<нрзб>	unkn	<нрзб>,SLIP
=kə	unkn	=FOC
=tə	unkn	FOC
?	unkn	?
???	???	???
???	unkn	???
Birigadir	unkn	бригадир
D’u	unkn	дом
Iz	unkn	Из
Jakowlewna	unkn	Яковлевна
Kislakan	unkn	Кислокан
Krasnojarskə	unkn	Красноярск
L'owa	unkn	Лёва
Lesosibirskə	unkn	Лесосибирск
Lesosibisko	unkn	Лесосибирск
NEG.IMPER2SG.SLIP	unkn	SLIP
Natalja	unkn	Наталья
Pramhoz	unkn	Промхоз
Saša	unkn	Саша
Trafim	unkn	Трофим
Trofim	unkn	Трофим
Udigir	unkn	Удыгир
Wala	unkn	Валя
Wit'a	unkn	Витя
[baldi	unkn	[вырасти.родиться
[bēga	unkn	[месяц
[bələ	unkn	[помочь
[in	unkn	[жить
[iroktu[при.расшифровке]]	unkn	[лиственница]
[načal	unkn	[начал
[nu	unkn	[ну
[o	unkn	[стать
[timə̄ltāna	unkn	[утром
[umukōn]	unkn	[один]
[uďa	unkn	[след
[uŋtuwu	unkn	[бубен
[vəsnoju]	unkn	[весной]
[неразборчиво]	unkn	[неразборчиво]
[нрзб]	[нрзб]	[нрзб],м
[нрзб]	unkn	[нрзб]
[при.расшифровке]]	unkn	[при.расшифровке]]
[технический перерыв в записи]	[технический перерыв в записи]	[технический перерыв в записи]
a	SLIP	SLIP
a	stem	INTJ,а
a	unkn	SLIP,спать,А,INTJ,1PL(EXCL),а,это,HES
ab	unkn	SLIP
aba	unkn	отец
abasralśa	unkn	обделался
abaču	stem	медведь
abaču=	SLIP	медведь.CHILD.SLIP
abačī	stem	медведь
abdun	stem	берлога
abdun	unkn	берлога
abduni	stem	берлога
abet	unkn	обед
abgarā	stem	выздороветь
abgarā	unkn	выздороветь
abična	unkn	обычно
abičnih	unkn	обычных
abižat	unkn	обижать
abligatsə	unkn	облигация
abrada	unkn	обрадоваться.SLIP
abradawalis	unkn	обрадовались
abratna	unkn	обратно
abratnə	unkn	обратно
abul	unkn	не.хватать,отсутствовать
abuli	unkn	не.хватить
abɨknawennaja	unkn	обыкновенная
adawu	unkn	увернуться
adi	unkn	сколько
adil'i	unkn	сеть
adil	unkn	сеть
adili	unkn	сеть
adilil	unkn	сеть.SLIP
adin	unkn	один
adiďa	unkn	несколько
adī	unkn	сколько
adnaždɨ	unkn	однажды
adī	unkn	сколько
adīkān	unkn	немного
adīkū	unkn	немногий
adəli	unkn	сеть
adɨl	stem	сеть
ag	stem	причалить
agatskəjə	unkn	агатский
agdi	unkn	греметь(о.громе)
agi	stem	причалить
agī	unkn	лес,тайга
aha	stem	ага,женщина.PLSTEM,гнать
aha	unkn	INTJ,гонять,догнать,гнать,ага,женщина.PLSTEM
ahahadu	unkn	?
ahal	unkn	женщина.PL
ahatawet	unkn	охотовед
ahatka	unkn	девочка,девушка
ahatkan	unkn	девочка,девушка
ahatkān	unkn	девушка
ahi	stem	женщина
ahi	unkn	жена,еще,женщина
ahota	stem	охота
ahotit	unkn	охотиться
ahotnik	unkn	охотник
ahotńik	unkn	охотник
ahoťi	unkn	охотиться
ahoťilśa	unkn	охотился
ahāl	unkn	женщина.PL
ahī	stem	женщина
ahī	unkn	жена,женщина
ahīli	unkn	жениться
ahū	stem	тронуть
ahū	unkn	тронуть
aj	stem	вылечить,помочь
aj	unkn	вылечить,добыть,SLIP,помочь
aja	stem	хороший
aja	unkn	рыба,хороший.SLIP,хороший
ajalə	stem	отсутствующий
ajamamat	unkn	очень.хорошо
ajan	unkn	хороший.SLIP
ajat	unkn	хорошо
ajaw	stem	любить
ajawu	unkn	любить
ajā	unkn	заводь
aji	stem	вылечить
aji	unkn	вылечить,лечить
ajiwuk	unkn	сытый
ajiči	unkn	вылечить
ajāwrī	unkn	любимый
ajō	unkn	хороший
ak	stem	причалить
ak	unkn	SLIP
akazyvajica	unkn	оказывается
aki	unkn	старший.брат,старший.брат.SLIP
akin	unkn	брат,старший.брат
akini	unkn	старший.брат
akir	unkn	старший.брат
akni	unkn	старший.брат
aknil	unkn	старший.брат.PL
aksa	stem	обидеться
aktabr'	unkn	октябрь
akuratnə	unkn	аккуратно
akču	unkn	стремиться,вырываться
akī	unkn	старший.брат
al'iksandr	unkn	Александр
al'in'əj	unkn	оленей
al'oša	unkn	Алеша
al'ošə	unkn	Алеше
al'ošəj	unkn	Алешей
al'ənjiva	unkn	оленьего
al'əńəj	unkn	оленей
al	unkn	SLIP,Алешей.SLIP
ala	unkn	SLIP
alagu	stem	научить
alagu	unkn	учить,научить
alagū	stem	научить
alagū	unkn	учить,научить
alan	unkn	переждать
alat	unkn	ждать
alawu	stem	научить
alaśi	unkn	ждать
alāt	unkn	ждать
alāči	unkn	ждать
alaγu	unkn	учить,научить
alba	stem	не.мочь
alba	unkn	не.мочь
aleksandr	unkn	Александр
aleksej	unkn	Алексей
aleksejewna	unkn	Алексеевна
alik	unkn	Алик
alit	unkn	выпрашивать
altat	stem	умолять
altaśi	stem	умолять,умолить
altaśi	unkn	умолить
altin	unkn	отвернуться
altāči	stem	умолять
alāt	stem	ждать
alāt	unkn	ждать
alāśi	stem	ждать
alāśi	unkn	ждать
alən'	unkn	олень
alən'a	unkn	оленя
aləńi	unkn	олени
aləńivot	unkn	оленевод
am	SLIP	раньше.SLIP
am	unkn	SLIP,отец
ama	unkn	дедушка,дедушка.SLIP
amak	unkn	дедушка.SLIP
amaka	unkn	дед{*},дедушка,дед
amakakan	unkn	недолго
amakā	unkn	дедушка
amakīkan	unkn	вскоре
aman	unkn	SLIP
amandī	unkn	опоздать
amar	stem	зад
amar	unkn	зад,место.позади
amargi	unkn	задняя.нога
amargū	stem	последний
amari	stem	зад
amari	unkn	зад
amarin	unkn	оставленная.стоянка
amaski	unkn	раньше
amaskī	unkn	назад
amaskā	unkn	место.позади
amaskī	stem	назад,раньше
amaskī	unkn	раньше,обратно,назад
amańa	unkn	скоро
amańā	stem	скоро
amaški	unkn	назад
amā	unkn	отец
amākā	unkn	дедушка
ambar	unkn	Амбар
ami	stem	отец
ami	unkn	SLIP,отец
amin	stem	отец
amin	unkn	отец.SLIP,отец
amini	unkn	отец
amiw	unkn	отец.SLIP
amki	unkn	полог,полог.SLIP
amkil	unkn	полог.SLIP
amkilə	unkn	полог.SLIP
amkin	unkn	амкин,полог
amta	unkn	почуять
amtat	unkn	нюхать
amtil	unkn	родители,родитель.PL
amtīl	unkn	родитель.PL
amu	unkn	навоз
amud'i	unkn	озеро
amut	stem	озеро
amut	unkn	озеро
amuti	stem	озеро
amuďi	unkn	озеро
amā	unkn	дедушка
amākā	stem	дедушка
amākā	unkn	дедушка,дед
amākāj	unkn	дедушка.SLIP
amī	stem	отец
amī	unkn	оттец,отец
amīn	unkn	отец
amīni	unkn	отец
amŋa	stem	рот
amŋa	unkn	рот
amūt	unkn	озеро
amə̄	stem	отец.VOC
an'i	unkn	они
an	stem	правый
an	unkn	правый,SLIP,это,год.SLIP
ana	stem	открыть,толкнуть
ana	unkn	вещь?,двигать,она,Анна,толкнуть
anan	unkn	специально,специально{*}
anan{*}	unkn	специально
andrej	unkn	Андрей
ani	unkn	это,они
anin	unkn	мать
anitə	unkn	они.то
anna	unkn	Анна
anti	stem	какой
anti	unkn	сколько,который,какой
antil	unkn	родитель.PL
antiptiki	unkn	разный
antiptikin	unkn	разный
anton	unkn	Антон
anŋani	unkn	год
anŋanī	unkn	год
anŋanī	unkn	год
anŋańī	stem	год
anŋańī	unkn	год
anŋaɲī	stem	год
anŋit	unkn	переночевать
anŋu	unkn	правый
ap'at'	unkn	опять
ap'at	unkn	опять
ap'ať	unkn	опять
apat	stem	опять
aprel	stem	апрель
aprəla	unkn	апреля
aprəl’	unkn	апрель
ap’at’	unkn	опять
ar	SLIP	встретить.SLIP
ar	unkn	SLIP
ara	unkn	чуть,еле,едва
araku	unkn	тихo
arakū	stem	тихo
arakūkān	unkn	потихоньку
arakūn	stem	тихo
aral	unkn	еле
arama	unkn	еле
aramā	unkn	еле.еле
aran	stem	еле
aran	unkn	чуть,еле
argiš	unkn	аргиш
argišit'	unkn	аргишить
arki	unkn	проткнуть
arm'ija	unkn	армия
armii	unkn	армии,армии....
armija	stem	армия
armija	unkn	армия
armije	unkn	армия
armijə	unkn	армия
arnold	unkn	Арнольд
arsa	unkn	встретить
arsamka	stem	выйти.навстречу
artist	unkn	артист
aru	unkn	ожить
aružija	unkn	оружия
aružijə	unkn	оружие
arča	stem	встретить
arča	unkn	встретить
arčamka	stem	выйти.навстречу
arčə	unkn	встретить
arčəmka	unkn	пойти.встретить
arən	unkn	чуть
asa	stem	гнать
asa	unkn	женщина.PLSTEM,гнать
asatka	unkn	девочка
asā	unkn	женщина
asi	unkn	NEG
asin	unkn	NEG
asī	unkn	женщина
asnavnom	unkn	основном
asnavnon	unkn	основном
asobino	unkn	особенно
ast'əahandroz	unkn	остеохондроз
astalnijə	unkn	остальные
astavl'ali	unkn	оставляли
asī	unkn	женщина
as’in	unkn	NEG
at	SLIP	SLIP,старуха.SLIP
atboj	unkn	отбой.
atd'əlnij	unkn	отдельный
atdajotsa	unkn	отдается
atirka	stem	старуха
atirka	unkn	старуха
atirkan	stem	старуха
atirkan	unkn	старуха
atirkani	unkn	старуха
atirkā	stem	старуха
atirkān	stem	старуха
atirkān	unkn	старуха
atirkāni	stem	старуха
atiwrəs	unkn	SLIP?в.это.время?
atkazivajut	unkn	отказывают
atlisniki	unkn	отличник
atmətka	unkn	отметка
atpravl'al'i	unkn	отправляли
atslužil	unkn	отслужил
attuda	unkn	оттуда
aturwə	unkn	???
atyrkan	unkn	старуха
atyrkon	unkn	муж
atɨn	unkn	???
atɨr	unkn	старуха.SLIP
atɨrkā	stem	старуха
atɨrkān	stem	старуха
atɨrkāni	stem	старуха
atɨrkār	unkn	старуха.PL.SLIP
avgust	unkn	август
avtadarožnij	unkn	автодорожный
awa	unkn	Ава
awadi	unkn	какой
awadɨ	stem	который
awgusta	unkn	август
awi	unkn	пройти.по.насту(об.олене)
awu	unkn	мыть
awun	stem	шапка
ači	stem	NEG
ači	unkn	NEG
ačin	stem	NEG
ačin	unkn	NEG
ačkah	unkn	очках
ački	unkn	очки
aďil	unkn	сеть
aďili	unkn	сеть
aďin	unkn	один
aīf	stem	насытиться
aīw	stem	насытиться
aīwuk	stem	сытый
aīwuki	stem	сытый
ańi	unkn	они
aŋ	stem	это
aŋ	unkn	этот,это
aŋa	stem	открыть
aŋa	unkn	открыть
aŋa=	unkn	год.SLIP
aŋad’akan	unkn	сирота
aŋan	unkn	правый
aŋani	unkn	год
aŋanī	unkn	год
aŋaďakā	stem	сирота
aŋaďakō	stem	сирота
aŋańi	unkn	год
aŋańī	unkn	год
aŋaťidū	unkn	год.SLIP
aŋe	unkn	это
aŋi	stem	это
aŋi	unkn	что,это
aŋil	unkn	этот.LOCALL.SLIP,это.SLIP
aŋima	unkn	это.SLIP???
aŋind’a	unkn	SLIP
aŋkī	unkn	спать.PSTITER.SLIP
aŋnanī	unkn	год
aŋti	unkn	какой
aŋu	stem	это
aŋī	unkn	это
aŋə	stem	это
aŋə	unkn	открывать,это
aśi	stem	NEG
aśi	unkn	NEG
aśin	stem	NEG
aśin	unkn	NEG
aśī	stem	жена
aš	unkn	сколько.SLIP
ašal	unkn	женщина.PL
ašikta	unkn	ель
ašun	stem	сколько
ašun	unkn	сколько
ašuna	unkn	сколько
aťets	unkn	отец
aɲi	unkn	они
ā	unkn	спать
ānmu	unkn	скоро
ās'i	unkn	NEG
ās'in	unkn	NEG
āŋa	unkn	открыть
āśin	unkn	NEG
aγa	stem	INTJ
aγa	unkn	ага,INTJ,догнать
aγata	unkn	Агата
aγi	unkn	лес
aγī	unkn	лес,лес.SLIP
aγā	unkn	женщина
aγī	stem	тайга
aγī	unkn	жена
b'er’igu	unkn	берегу
b'ir'is	unkn	бересты.SLIP
b'ir'isti	unkn	бересты
b'irlog'ə	unkn	берлоге
b'ərlog'i	unkn	берлоги
b'əz	unkn	без
b	SLIP	SLIP
ba	unkn	SLIP
ba[при.расшифровке:ka]	unkn	[найти]
babaji	unkn	бабай,бабай{*}
babuška	unkn	бабушка
babuški	unkn	бабушки
badara	stem	сгореть,сжечь
badara	unkn	лесной.пожар,спалить.лес
badaran	stem	сжечь
bag	unkn	белый.SLIP
bagatɨj	unkn	богатый
bagatɨji	unkn	богатый
bagda	unkn	белый.SLIP
bagdakāśi	stem	с.белыми.пятнами
bagdakə	stem	дикий.олень
bagdakə̄	unkn	дикий.олень
bagdama	stem	белый,побелеть
bagdama	unkn	белый
bah	unkn	бах
bahilaj	unkn	Василий
baj	unkn	богатый
bajalśa	unkn	боялся
baji	stem	богатый
baji	unkn	богатый
bajkiśi	unkn	Байкит
bajkowa	unkn	Байкова
baka	stem	найти
baka	unkn	находить,найти
bakaśiwkā	unkn	найти.DISTR.CAUS.SLIP
bakdākə	stem	дикий.олень
bal	unkn	вырасти.родиться.SLIP,SLIP
baldi	stem	родиться
baldi	unkn	вырасти,родить,вырасти.родиться,родиться.вырасти,вырасти.родиться.SLIP,родиться/расти,родиться
baldy	unkn	родиться
baldī	unkn	родиться
baldɨ	stem	вырасти,родить,родиться
bald’i	unkn	родиться
bali	unkn	помочь
balnitsa	unkn	больница
balok	unkn	балок
baloki	unkn	балок
balowali	unkn	баловали
baluwat	unkn	баловаться
balďi	unkn	вырасти,родить,родиться
balī	stem	ослепнуть,слепой
balī	unkn	ослепнуть
balšiji	unkn	большие
bal’di	unkn	родиться
bam	unkn	SLIP
bar	unkn	другая.сторона.SLIP
bargidā	stem	другая.сторона
bargidā	unkn	другой.берег
bargiskī	stem	на.другой.берег
bargiskī	unkn	на.другой.берег
bargī	stem	другая.сторона
bargī	unkn	другой.берег
bargīlā	stem	на.другую.сторону
barža	unkn	баржа
barži	unkn	баржа
bati	unkn	поместиться
baza	unkn	база
baďap	unkn	кривой(о.ногах)
baďāl	unkn	кривой(о.ногах)
baďālə	stem	кривой[о.ногах]
baďālə	unkn	кривой(о.ногах)
baŋtɨka	stem	неровное.кочковатое.место
bedńińko	RUS	бедненько
bega	unkn	месяц
beli	unkn	белый
belku	unkn	белку
benzin	unkn	бензин
bereste	unkn	береста
besnaji	stem	бедный
bēga	unkn	месяц
beγa	unkn	луна,месяц
bi	SLIP	быть.SLIP
bi	root	1SG,быть
bi	stem	1SG,быть
bi	unkn	1SG,я,бы,до,быть,план,река.SLIP,SLIP,1SG.SLIP,быть.SLIP
bi-	unkn	быть
bi=	unkn	1SG.SLIP,SLIP
biblioťekar	unkn	библиотекарь
bid	unkn	SLIP
bida	unkn	SLIP
bif	unkn	быть.SLIP
bil'i	unkn	были
bil	unkn	был
bila	unkn	была
bili	unkn	были
bilkəvali	unkn	белковали
bilkəvat’	unkn	белковать
bilo	unkn	было
bil’utə	unkn	бюллетень
bim	unkn	SLIP
bimnin	unkn	целиком
bimrək	unkn	навсегда
binhin	unkn	бензин
biolək	unkn	биолог
bir'oza	unkn	береза
bira	SLIP	река.SLIP
bira	stem	река
bira	unkn	река
biraja	stem	река
biraja	unkn	река
biral	SLIP	река.SLIP
biralī	unkn	река.PROL.SLIP
birapčānə	stem	р.Бирапчана
biri	unkn	брызгать.SLIP
birigadir	unkn	бригадир
birigaďir	unkn	бригадир
birizgəwət	unkn	брызгать
birloge	unkn	берлоге
birok	SLIP	SLIP
birā	unkn	река
birə	unkn	река
bistr'əji	unkn	быстрее
bistro	unkn	быстро
biwuk	unkn	все.время
bič	unkn	быть.SLIP
bičəvoj	unkn	бечеве
bī	unkn	1SG,жить
bl'iska	unkn	близко
bo	unkn	осенью.SLIP
bodo	stem	быт
bodo	unkn	существовать,жизнь
boko	stem	догнать
boko	unkn	догнать
bokon	stem	догнать
bokon	unkn	догнать
bokoni	stem	догнать
bokonču	stem	догнать
bokonə	stem	догнать
bol'šə	unkn	больше
bol	unkn	осень.SLIP,больше.SLIP
bolgiśa	stem	притеснять
bolinī	unkn	осень
bolnisa	unkn	больница
bolnitsa	unkn	больница
bolnitsə	unkn	больница
bolo	stem	осенью
bolo	unkn	осенью,осень,настать(об.осени),осень.SLIP
bolō	unkn	осенью
bolšoj	unkn	Большой,большой
bolšə	unkn	больше
bol’šǝ	unkn	больше
bor	unkn	SLIP
boroŋgo	unkn	морошка
boroŋkon	unkn	Боронгкон,Боронкон
boroši	unkn	вещь
borī	stem	разделить
botulu	unkn	Ботулу
bočku	unkn	бочку
boľšəwiki	unkn	большевик
boγ	unkn	бог,Советское.Озеро,Бог
boγolo	stem	обделить.добычей
brali	unkn	брали
brat'	unkn	брать
brati	unkn	брат
bratja	unkn	братья
brigada	unkn	бригада
brigaďiri	unkn	бригадир
brizgiwiti	unkn	брызгатель
brusn'ika	unkn	брусника
bu	stem	дать,1PL(EXCL),умереть
bu	unkn	убить,1PL(EXCL),1Pl(EXCL),мячик,дать,SLIP,уже,умереть,1pl(excl)
bubinta	unkn	бубен.то
bud'im	unkn	будем
bud'it	unkn	будет
buhalter	unkn	бухгалтер
buktarani	stem	шлепнуть
buktu	unkn	упасть.поскользнувшись
bukwar	unkn	букварь
bul	unkn	SLIP,охотиться.SLIP
buldi	unkn	образоваться(о.льде)
bulta	stem	добыча,добыть
bulta	unkn	охотиться,добыть,добыча,охотиться.SLIP
bultā	unkn	охотиться,добывать,добыча,охота
bul’ta	unkn	охотиться
bun	unkn	SLIP
bur	stem	остров
bur	unkn	мука.SLIP
buran	stem	Буран
buran	unkn	буран,Буран
burani	unkn	буран,Буран
burannu	unkn	Буран.SLIP
burduk	unkn	мука
burduka	unkn	мука
burdukari	unkn	мука.SLIP
burgak	unkn	заросший.берег
burgu	stem	жирный
burgu	unkn	жирный
burgī	unkn	разбить
buri	stem	уронить
burkī	unkn	обтянуть
bursə	unkn	болеть
buru	stem	упасть
buru	unkn	выпасть,упасть,падать
buruś	unkn	упасть.SLIP
burī	unkn	уронить
burū	unkn	падать,упасть
burγə	unkn	SLIP
bus	unkn	SLIP
buslə	stem	болеть
buslə	unkn	больной,болеть
buslә	unkn	болеть
bussə	stem	болеть
bussə	unkn	болеть
butta	unkn	будто
butto	unkn	будто
buttobi	unkn	будто.бы
buńī	stem	завыть
buńī	unkn	завыть
bušči	unkn	болеть
buššə	unkn	болеть
buɲī	stem	вой,завыть
buɲī	unkn	завыть
bū	unkn	дать,дать.SLIP,1PL(EXCL)
būiŋkə	unkn	дать.SLIP
buγaďa	unkn	расстроиться
by	unkn	бы
byl	unkn	был
byli	unkn	были
bylitə	unkn	были.то
bylə	unkn	было
byl’i	unkn	были
bā	unkn	отказаться,не.хотеть
bē	unkn	личная.сторона
bēdńij	unkn	бедный
bēga	stem	месяц
bēga	unkn	месяц
bēγa	stem	месяц
bī	unkn	1SG,я,быть,1sg
bīhə	unkn	SLIP
bū	stem	дать
bū	unkn	дать,1PL(EXCL),давать,умереть
būh	unkn	бух
būńī	unkn	выть
bə	unkn	SLIP,быть,бы
bə:γa	unkn	месяц
bəiŋə	unkn	зверь
bəj	unkn	охотиться.на.дикого.оленя
bəjacə	unkn	боятся
bəjdə	unkn	слепой[мститель?]
bəji	unkn	человек
bəjiŋō	unkn	дикий.олень/зверь
bəjnō	unkn	зверь/дикий.олень
bəjo	stem	ожить,ожить[нет.в.словаре]
bəjo	unkn	человек.мужчина,[слова нет в словаре],SLIP
bəju	stem	дикий.олень
bəjun	unkn	дикий.олень
bəjuš	unkn	охотиться
bəjušə	unkn	охотиться
bəjī	unkn	злиться
bəjīt	unkn	отомстить
bəjŋo	unkn	дикий.олень
bəjŋō	unkn	зверь
bəjŋō	stem	дикий.олень
bəjŋō	unkn	дикий.олень,зверь,зверь/дикий.олень
bəjə	stem	человек.мужчина
bəjə	unkn	человек.мужчина,человек.SLIP,мужчина.SLIP,человек,мужчина,мужчина.человек
bəjədātə̄=	SLIP	человек.мужчина.FOC.FOC.SLIP
bəjət	unkn	SLIP
bəlin	stem	истерик
bələ	stem	помочь
bələ	unkn	помочь.SLIP,помогать,помочь
bəlγə	stem	испугаться
bəl’šojə	unkn	большое
bər'asty	unkn	бересты
bər	unkn	лук
bərəst'a	unkn	slip
bərəst'anoj	unkn	берестяной
bɨ	unkn	бы
bɨl	RUS	был
bɨlo	unkn	было
bәles	unkn	болезнь
bәlezn’	unkn	болезнь
bәlә	unkn	помочь
b’id’n’aškə	unkn	бедняжка
b’inzin	unkn	бензин
celij	unkn	целый
celəj	unkn	целый
d'ab	unkn	лодка
d'ad'a	unkn	дядя
d'aja	unkn	спрятать.SLIP,спрятать,прятать
d'ali	unkn	ум
d'apkun	unkn	восемь,восемь.SLIP
d'aw	unkn	лодка
d'awa	unkn	схватить
d'awi	unkn	лодка
d'awūča	unkn	держать
d'ār	unkn	десять
d'eb	unkn	есть
d'ep	unkn	есть,съесть
d'il'il'i	unkn	делили
d'ir'ektor	unkn	директор
d'it'əj	unkn	детей
d'iv'anostom	unkn	девяностом
d'ī	unkn	засунуть
d'o	unkn	SLIP
d'on	unkn	запомнить
d'oni	unkn	запомнить
d'onča	unkn	запомнить
d'oromo	unkn	украсть
d'ōn	unkn	вспомнить
d'u	unkn	чум
d'ujapču	unkn	ягода
d'uk	unkn	SLIP
d'ukča	unkn	двое
d'ukčan	unkn	двое.SLIP
d'uwu	unkn	перетащить
d'ū	unkn	чум,дом
d'ūr	unkn	два
d'ū	unkn	чум
d'ūr	unkn	два
d'ə	unkn	съесть
d'əlajəm	unkn	делаем
d'əlakī	unkn	горностай
d'əlal'i	unkn	делали
d'əlalalas'	unkn	делалась
d'əlali	unkn	делали
d'ən	unkn	день
d'əp	unkn	есть
d'əri	unkn	мелькать
d'ər’əvn’a	unkn	деревня
d'ət'i	unkn	дети
d'əv'at'	unkn	девять
d'əwtilə	unkn	еда
d'əŋkə	unkn	соболь
d'е	unkn	SLIP
da	unkn	да,SLIP,до
dabuval	unkn	добывал
dada	unkn	Дада
daga	stem	место.рядом
daga	unkn	близкое.место,место.рядом
dagama	stem	приблизиться
dagama	unkn	приблизиться
dagamā	stem	приблизиться
dagī	stem	рядом
dagī	unkn	место.рядом,близкий,рядом
daj	SLIP	место.рядом.SLIP
daj	unkn	дай
dajizžaja	unkn	доезжая
dak	unkn	так,переправиться
dakuda	unkn	докуда
dal'šə	unkn	дальше
dal	unkn	SLIP
dale	unkn	далеко.SLIP
daleko	unkn	далеко
damatə	unkn	дома.то
damka	unkn	Дамка
dan	unkn	SLIP
danila	unkn	Данила
dapda	unkn	быть.побежденным
daran	stem	рядом
dari	unkn	место.в.стороне
dariski	unkn	в.сторону
dariskī	stem	в.сторону
darja	unkn	Дарья
darki	unkn	стать(о.насте)
darkin	unkn	наст
darī	unkn	в.стороне
das	stem	закрыть
dasna	stem	крышка
dasna	unkn	крышка
dastat'	unkn	достать
daurskij	unkn	Даурский
davno	unkn	давно
dawaj	unkn	давай
dawarsa	stem	идти.наперерез
dawda	stem	поддаться,тянуть.вниз
dawno	unkn	давно
dawďī	unkn	победить
daša	unkn	Даша
daže	unkn	даже
dažə	stem	даже
dažə	unkn	даже
daγa	stem	подойти
daγa	unkn	близкий
daγam	unkn	приблизиться.SLIP
daγamā	stem	приблизиться
daγi	unkn	место.рядом,рядом
daγī	stem	место.рядом
deduška	unkn	дедушка
delajum	unkn	делаем
deneg	unkn	денег
den’	unkn	день
den’gi	unkn	деньги
deptilə	unkn	продукт
di	unkn	вложить
digalī	unkn	Дигали
digin	unkn	четыре
digind’ar	unkn	сорок
digit	unkn	из.леса
diktə	unkn	ягода
dil	stem	голова
dil	unkn	голова
dilasā	unkn	солнце
dilač	unkn	солнце.SLIP
dilača	unkn	солнце
dildan	unkn	воображать,воображать.SLIP
dili	stem	голова
dili	unkn	голова
dilo	stem	в.лесу
dilo	unkn	в.лесу
dinīlə	unkn	бежать
dinŋīlə̄	stem	бежать.галопом
dinŋīlə̄	unkn	бежать.галопом
dinŋīlə̄n	stem	бежать.галопом
dinŋīlə̄n	unkn	бежать.галопом
dinŋīlə̄ni	stem	бежать.галопом
dinŋīlə̄s	unkn	бежать.галопом.SLIP,бежать.галопом
diplom	unkn	диплом
direktəri	unkn	директор
dirgə	stem	пробиться
dirəktor	unkn	директор
diski	unkn	в.лес
diskī	stem	в.лес
div'atom	unkn	девятом
div'atsot	unkn	девятьсот
dizilisti	unkn	дизелист
diŋnilən	unkn	бежать.галопом
diŋnī	unkn	четверо
diŋnīlə̄	unkn	бежать.галопом,бежать
diŋnīlə̄n	unkn	бежать.галопом
diγi	unkn	четыре
diγin	unkn	четыре
diγind'ār	unkn	сорок
diγinďan	unkn	сорок
dl'a	unkn	для
dmitrij	unkn	Дмитрий
dmitrijewich	unkn	Дмитриевич
dmitrijəvič	unkn	Дмитриевич
dmitrijəvna	unkn	Дмитриевна
dn'a	unkn	дня
do	stem	внутреннее.пространство
do	unkn	гриб.SLIP
do...	unkn	до...
doga	unkn	подойти
doktur	unkn	доктор
doku	unkn	SLIP,написать.SLIP,написать
dokuməntə	unkn	документ
dolbo	stem	настать(о.ночи),ночью
dolbo	unkn	настать(о.ночи),ночью
dolboltono	stem	вечером
dolboltono	unkn	вечером
dolboltonə	unkn	вечером,вечер
dolboltənə	unkn	вечером
dolbontono	stem	вечером
dolbonī	unkn	ночь
dolbō	unkn	ночью
doldi	unkn	услышать,слышать
doldɨ	stem	слышать
dolg'ij	unkn	долгий
dolgo	unkn	долго
dolgoj	unkn	долгой
dolgə	unkn	долго
dolgә	unkn	долго
doma	unkn	дома
domom	unkn	домом
don	unkn	помнить
dowin	unkn	гриб.SLIP
dowiŋōktə	unkn	гриб
dočka	unkn	дочка
doŋoto	stem	замерзнуть
doŋoto	unkn	замерзнуть
dōldī	unkn	слышать
dōldī	unkn	слышать
doγi	unkn	лететь
doχturi	unkn	доктор
dr	unkn	SLIP
drobi	unkn	дроби
drop	unkn	дробь
drova	unkn	дрова
drugoj	unkn	другой
du	unkn	SLIP
dudinka	unkn	Дудинка
dugi	unkn	долбить(лед)
dugə̄	stem	вершина.дерева
dujinkok	unkn	???
duktə	stem	колотить
duktə	unkn	вдвоем,колотить
duku	stem	написать
duku	unkn	писать.SLIP,писать,написать
dukū	unkn	писать
dukə	unkn	лед
dulbun	stem	дурак
duli	stem	середина
dulin	stem	середина
dulin	unkn	середина
dulini	unkn	половина
dulumnū	stem	спокойный
dulə	stem	дуло
dulə̄mə̄	stem	прийти.раньше
dulə̄mə̄	unkn	прийти.раньше
dumaj	stem	думать
dumaj	unkn	думать
dumaji	stem	думать
dumaju	unkn	думаю
dumala	unkn	думала
dun	unkn	земля.SLIP
dundi	unkn	земля
dundə	stem	земля
dundə	unkn	земля
dunnə	stem	земля
dunnə	unkn	земля
dup	unkn	не.мочь
dur	unkn	SLIP
durd’ar	unkn	двадцать
dusama	stem	чистый
dutu	unkn	пересечь.мыс
duwukī	stem	крестец
dv'ə	unkn	две
dva	unkn	два
dvatsatih	unkn	двадцатых
dvatsatovo	unkn	двадцатого
dvinatsatavo	unkn	двенадцатого
dvoih	unkn	двоих
dvə	unkn	две
dwuhgadawalij	SLIP	двухгодовалый
dygind’ar	unkn	сорок
dymokur	unkn	дымокур
dymokura	unkn	дымокура
dāg	stem	переправиться
dāg	unkn	переправиться,перебраться
dāgi	stem	переправиться
dār	unkn	расщепить
dāri	unkn	расщепить
dāγi	stem	переправиться
dī	stem	вложить
dīgin	unkn	четыре
dīkən	stem	спрятаться
dīldulī	stem	по.тайге
dīlī	unkn	по.склону.горы
dīlə̄	unkn	в.лесу
dīskī	stem	дальше
dīskī	unkn	вверх.по.склону,в.лес,от.реки
dīγinďan	unkn	сорок
dńom	unkn	днем
dō	stem	сесть[о.птице],внутреннее.пространство
dō	unkn	сесть(о.птице),внутреннее.пространство
dōhin	unkn	крыша
dōl'ča	unkn	слушать
dōldi	unkn	слышать
dōldī	unkn	слышать
dōldī	stem	слышать
dōldī	unkn	слышать
dōldɨ	stem	слышать
dōlčā	stem	слушать
dōlčāt	stem	слушать
dōlčāt	unkn	слушать
dōskī	stem	вовнутрь
dōwa	unkn	подойти
dūktə̄	unkn	вдвоем
dūku	unkn	написать
dūndə	unkn	земля
dūr	unkn	два
də	unkn	да,птица.SLIP,до
dəg	stem	лететь
dəg	unkn	летать,лететь
dəgi	stem	лететь,птица
dəgi	unkn	лететь,птица
dəgil	unkn	лететь
dəgilmə	unkn	гриб.SLIP
dəgilmə̄ktə	stem	гриб
dəginnə	unkn	гриб.SLIP
dəginti	unkn	левый,левша
dəgďəri	unkn	лететь.IPFV.PSIM.SLIP
dək	unkn	так
dəktəndə	stem	крыло
dəlkən	unkn	лабаз
dəma	unkn	дома
dən'gi	unkn	деньги
dərinə	stem	мелькать
dəro	unkn	исток
dəru	unkn	устать
dərumdə	unkn	устать.SLIP
dərumki	unkn	отдохнуть
dərumkiśə	stem	отдохнуть
dərumkī	unkn	отдохнуть
dərūmkičə	unkn	отдохнуть
dərū	stem	устать
dərū	unkn	устать
dərūmkisa	unkn	отдохнуть
dərūmkīčə	stem	отдохнуть
dərə	stem	лицо
dərə	unkn	лицо
dəw	unkn	лететь
dəŋke	unkn	соболь
dəŋkə	unkn	соболь
də̄	SLIP	SLIP
dəγi	stem	прилететь,птица
dəγi	unkn	летать,прилететь,лететь,птица
dəγilmakta	unkn	гриб
dəγinməktə	unkn	гриб
dəγī	unkn	лететь
dɨkə	stem	спрятаться
dɨkən	stem	спрятаться
dɨl	stem	голова
dɨlasa	stem	солнце
dɨli	stem	голова
dɨlma	stem	голова
dɨlī	stem	по.тайге
dɨγin	stem	четыре
dʒəb	unkn	есть
dәgi	unkn	лететь
dәk	unkn	так
dәŋkə̄	unkn	соболь
dәγ	unkn	лететь
d’a	unkn	SLIP,съесть,росомаха.SLIP,друг,родственник,поймать.SLIP
d’adani	unkn	бедный(безоленный)
d’al	unkn	ум
d’alda	unkn	думать
d’an	unkn	десять.SLIP,десять
d’antaki	unkn	росомаха
d’anu	unkn	десять
d’ap	unkn	съесть,съесть.SLIP,есть,лодка
d’apka	unkn	восемь
d’apki	unkn	восьмой
d’apku	unkn	восемь
d’apkun	unkn	восемь
d’apkund’ar	unkn	восемьдесят
d’apkī	unkn	восьмой
d’aptyli	unkn	продукт
d’aw	unkn	лодка,съесть
d’awa	unkn	схватить,поймать
d’awana	unkn	поймать.SLIP
d’awi	unkn	лодка
d’awu	unkn	съесть,поймать
d’awusa	unkn	держать
d’awūsa	unkn	держать
d’eləl	unkn	делал
d’etsə	unkn	деться
d’iktə	unkn	ягода
d’imen’t’jəw	unkn	Дементьев
d’im’en’t’jəf	unkn	Дементьев
d’ižur’i	unkn	дежурить
d’iγi	unkn	SLIP
d’ońta	unkn	вспомнить
d’ońt’a	unkn	вспомнить
d’u	unkn	дом,летом.SLIP,чум,поменять.SLIP,дом.чум,SLIP,дом.чум.SLIP,два
d’uga	unkn	летом,проводить(о.лете),провести(о.лете)
d’uganī	unkn	лето
d’ukto	unkn	двое
d’uktə	unkn	двое
d’ulapti	unkn	передний.отросток.на.роге
d’uloski	unkn	вперед
d’ulə	unkn	перед
d’ur	unkn	две,два
d’ura	unkn	дважды
d’urdar	unkn	двадцать
d’urd’ar	unkn	двадцать
d’urwə	unkn	SLIP
d’uwal	unkn	дом.чум.SLIP
d’uγa	unkn	летом,провести(о.лете),лето
d’uγati	unkn	поменять
d’uγači	unkn	поменять
d’īl	unkn	тайга
d’ōńťa	unkn	вспомнить
d’ū	unkn	дом.чум,дом
d’ə	unkn	подпевать.SLIP,съесть.SLP
d’əm	unkn	съесть
d’əp	unkn	есть
d’əptilə	unkn	еда,продукт
d’əptilə̄	unkn	еда
d’əru	unkn	подпевать
d’ərul	unkn	подпевать.SLIP
d’ər’ev’n’ə	unkn	деревня
d’əw	unkn	есть
d’əwa	unkn	ловить
d’əwu	unkn	състь,съесть
d’ə̄	unkn	супруг
d’ə̄wa	unkn	поймать
ej	unkn	hes
ekologičeskaji	unkn	экологический
eksp'eďitsija	unkn	экспедиция
ekspeditija	unkn	экспедиция
ekspeditsija	unkn	экспедиция
ekspeďitsija	unkn	экспедиция
ekspeďitsijə	unkn	экспедиция
ekspəditsijə	unkn	экспедиция
epiďemija	unkn	эпидемия
eta	unkn	эта
eti	unkn	эти
etitə	unkn	эти.то
eto	unkn	это
etot	unkn	этот
etowo	unkn	этого
et’i	unkn	эти
ē	unkn	что
ēku	unkn	что
ēkun	unkn	что,кто
f'odor	unkn	Федор
f'odər	unkn	Федор
f'so	unkn	все,всё.
f	unkn	в
fam'il’ijə	unkn	фамилия
familja	unkn	фамилия
fanari	unkn	фонарь
ferma	unkn	ферма
fewral	unkn	февраль
fewrale	unkn	феврале
fewralən	unkn	февраль
fini	unkn	финны
fpadajut	unkn	впадают
fpiri	unkn	SLIP
fpirot	unkn	вперед
fronta	stem	фронт
fronta	unkn	фронт
fs'akij	unkn	всякий
fs'e	unkn	все
fs'id'mom	unkn	в.седьмом
fs'igda	unkn	всегда
fs'o	unkn	все,и,всё
fs'u	unkn	всю
fseh	unkn	всех
fsigda	unkn	всегда
fsivo	unkn	всего
fspomn'il	unkn	вспомнил
fsta	unkn	вставали.SLIP
fstaval'i	unkn	вставали
fstr'ičalśa	unkn	встречался
fs’o	unkn	все,всё
ftaro	unkn	второй.SLIP
fśigda	unkn	всегда
fśo	RUS	все
fśo	unkn	все,всё
fśorawno	unkn	все.равно
ga	stem	взять
ga	unkn	SLIP,брать,взять
ga=	unkn	взять.SLIP
gadu	unkn	году
gaksā	stem	сушеная.рыба
gala	unkn	Галя
gana	unkn	SLIP
ganalči	unkn	стрелок
ganat	unkn	стрелять
ganaśi	unkn	стрелять
ganna	unkn	забрать
gan’a	unkn	Ганя
gara	stem	ветка
gara	unkn	ветка
garpa	unkn	стрелять
gatovi	unkn	готовить
gatoviji	unkn	готовые
gatovji	unkn	готовые
gavaritsa	unkn	говорится
gawar'u	unkn	говорю
gawarat	unkn	говорят
gawarit	unkn	говорит
gawaritsa	unkn	говорится
gawaru	unkn	говорю.SLIP,говорю
gawril	unkn	Гавриил
gańa	unkn	Ганя
gaŋa	unkn	сходить.за
gd'eta	unkn	где.то
gd'ə	unkn	где
gd'əto	unkn	где.то
gdeta	unkn	где.то
gd’i	unkn	где
ge	unkn	другой
geologi	unkn	геолог
gē	unkn	другой
gi	unkn	колотушка.SLIP,SLIP
gida	stem	проткнуть
gil	stem	другой.PL
gil	unkn	другой.PL
gilbəni	unkn	связать.караваном
giramda	stem	кость
giramda	unkn	кость
giramna	unkn	кость
giramətnə	unkn	грамотный
girani	stem	шагнуть
girki	unkn	друг
girkī	unkn	друг
girku	stem	ходить
girku	unkn	ходить.SLIP,ходить
girkuŋ	unkn	ходить.SLIP
girkuŋa	unkn	ходить.SLIP
girkuŋə	unkn	ходить.SLIP
girkī	stem	друг
girkī	unkn	друг
girkū	unkn	идти,ходить
gitlər	unkn	Гитлер
gišu	unkn	колотушка
glawnojə	RUS	главное
gnilu	unkn	slip
gniluski	unkn	гнилушки
gnilyje	unkn	гнилые
go	unkn	SLIP,год.SLIP
goda	unkn	года
godi	unkn	годы
godroždənijə	unkn	год.рождения
gogo	unkn	лаять,залаять
gojowūŋī	stem	ранить
gojōwli	unkn	подранить
golije	unkn	голые
golo	unkn	бревно
golomo	stem	зимний.чум
golowu	unkn	голову
golədu	unkn	голоду
gonda	unkn	Гонгда
goo	unkn	лаять
gorbī	unkn	имя
gori	unkn	горы
goro	stem	долгое.время,далекий
goro	unkn	далеко,долгий,место.вдали,долгое.время,долго,давнее.время,далекий,место.далеко
gorod	unkn	город
gorojō	unkn	долгое время
gorolō	unkn	место.вдали
goroski	unkn	далеко
gorot	unkn	город.SLIP,город
gorowo	unkn	SLIP,долго
gorošiha	unkn	Горошиха
gorō	unkn	далеко
got	unkn	год
gotowi	unkn	готовить
gotowij	unkn	готовый
gov	unkn	SLIP
gowo	unkn	лаять
goďo	unkn	SLIP
gońi	stem	гонять
goŋda	unkn	Гонгда
goša	unkn	Гоша
gōśīkta	unkn	следующий.год
goγo	stem	залаять
goγo	unkn	лаять
gr'it	unkn	говорит
gramatə	unkn	грамота
gramota	unkn	грамота
gramətə	unkn	грамота
gribkowije	unkn	грибковые
grip	unkn	гриб.SLIP
grit	unkn	говорит
griša	unkn	Гриша
grom	unkn	гром
grus	unkn	груз
gružili	unkn	грузили
gu	SLIP	SLIP
gu	stem	сказать
gu	unkn	SLIP,сказать,сказать.SLIP,сказать[?]
gu=	unkn	SLIP
gud'ēj	unkn	красивый
gugarə	stem	гугара
gugda	unkn	высокий
guja	unkn	бодать
gulbi	unkn	вскипятить
gule	unkn	деревянный.дом
gulu	unkn	изба,дом
guluwu	unkn	костер
guluwun	stem	костер
guluwun	unkn	костер,костёр
guluwurof	unkn	костер.PL.ов
guluča	unkn	сидеть.у.костра
gulušnəm	unkn	Глушнев
gulə	stem	деревянный.дом
gulə	unkn	изба/дом,деревянный.дом,изба
gumət	unkn	говорить.RECIP.SLIP
gun	SLIP	SLIP
gun	stem	сказать
gun	unkn	сказать.SLIP,сказать
gune	unkn	говорить
guni	stem	сказать
guni	unkn	сказать
gunil	unkn	сказать.INCH.SLIP
gunďəp	unkn	сказать.SLIP
gunə	stem	сказать
gunə	unkn	сказать
gun’	unkn	сказать
guru	unkn	SLIP
guruhi	unkn	груз,грузить.SLIP
guruhī	unkn	грузить
gurus	unkn	груз
gurušš’iki	unkn	грузчик
gus	unkn	орел
gutko	unkn	щука
guń	unkn	говорить,сказать
guńi	unkn	сказать
gū	unkn	сказать
gūlə	unkn	изба
gvarďəjəts	unkn	гвардеец
gā	stem	взять
gā	unkn	взять
gďə	unkn	где
gďətə	unkn	где.то
gē	stem	другой
gē	unkn	другой,второй
gēw	stem	сделать.вторично
gēwu	stem	сделать.вторично
gēŋa	stem	скулить
gī	unkn	другой
gōkča	unkn	соревноваться.SLIP,соревноваться
gōkčan	unkn	соревноваться
gōkčanə	unkn	соревноваться
gū	stem	сказать
gū	unkn	сказать
gūn	stem	сказать
gūn	unkn	сказать
gūń	unkn	сказать
gūńi	unkn	говорить
gə	unkn	SLIP,взять,другой
gədimuk	unkn	затылок
gədu	unkn	году
gələktə	stem	искать
gələktə	unkn	искать
gələktә	unkn	искать
gələ̄	unkn	искать.SLIP
gələ̄ktə	stem	искать
gələ̄ktə	unkn	искать
gənno	unkn	забрать.SLIP
gənnō	stem	забрать
gənnō	unkn	SLIP,забрать,взять,сходить.за
gənnə	stem	забрать
gənnə	unkn	забрать
gənnə̄	stem	забрать
gənnə̄	unkn	забрать
gənō	unkn	SLIP
gər	unkn	имя.SLIP
gərbi	stem	имя
gərbi	unkn	имя
gərbī	stem	имя
gərbī	unkn	название,назвать,имя
gətovili	unkn	готовили
gəvar'it	unkn	говорит
gəvar'u	unkn	говорю
gəw	unkn	сделать.вторично
gəwar'it'	unkn	сказать
gəwar'itsa	unkn	говорится
gəŋa	unkn	сходить.за
gəŋnā	unkn	сходить.за
gə̄	unkn	другой
gәnno	unkn	забрать
h	unkn	SLIP
ha	stem	знать
ha	unkn	slip,SLIP,часть,часть.SLIP,работать.SLIP
had'il'i	unkn	ходили
hag	unkn	старший.SLIP,старый.SLIP
hagda	unkn	стареть,постареть,старый
hagdan	unkn	постареть
hagdaγi	stem	старший
hagdi	unkn	старый.SLIP,старый
hagdī	unkn	старый
hagdɨ	stem	старый
hajalə	unkn	отсутствующий
hajalә	unkn	отсутствующий
hajālə	unkn	отсутствующий
haki	stem	печень
hakin	stem	печень
hakir	unkn	сахар
hakja	unkn	???
haktiri	unkn	темнота
haktirā	stem	темный
haktirā	unkn	стемнеть
haktɨr	stem	темнота
haktɨra	stem	стемнеть
haktɨriwču	stem	темный
haktɨrā	stem	стемнеть
haku	unkn	закрыть
halga	stem	нога
halga	unkn	провести(о.ранней.зиме),нога
halgališu	unkn	ранняя.зима
halgaləšu	unkn	ранняя.зима
halgan	stem	нога
halgan	unkn	нога
halgani	stem	нога
halgar	unkn	нога.PL.SLIP
ham	stem	закрыть
hama	stem	шаман
hamahal	stem	шаман.PL
hamalbi	stem	подпрыгивать
haman	stem	шаман
hamij	unkn	самый
hamilki	unkn	отметка
hamnī	unkn	дымокур
hamān	stem	шаман
hamān	unkn	шаман
hamāni	unkn	шаманить
hamńī	unkn	дымокур
hamńīn	unkn	дымокур
haməj	stem	самый
haməlkī	unkn	отметка
hantajskoj	unkn	Хантайское
hantajskojə	unkn	Хантайское
hanŋukta	unkn	спросить
hanŋūkta	unkn	спросить
hanŋūkta	stem	спросить
hanŋūkta	unkn	спросить
har	unkn	SLIP
haran	stem	место.огня
haran	unkn	место
harańi	unkn	хоронить
haraśo	unkn	хорошо
harašo	unkn	хорошо
hargi	unkn	лес
harikta	unkn	парить
harpukān	stem	шутник
harumukta	unkn	бровь
harūk	unkn	опьянеть
harūni	stem	закружиться(о.голове)
hata	stem	подушечка.лапы
hata	unkn	всё.ещё,вероятно
hatana	stem	черт
hatana	unkn	черт
hatun	unkn	шатун
hawa	SLIP	SLIP
hawa	stem	работа
hawa	unkn	работа.SLIP,работа
hawal'	unkn	работать,ходить
hawal'i	unkn	работать
hawal	stem	работать
hawal	unkn	ходить,работать,работать.SLIP
hawali	stem	работать
hawali	unkn	работать,ходить,здесь,работать.SLIP
hawalkŋi	unkn	работать.SLIP
hawal’	unkn	работать
hawaľ	unkn	работать
hawoda	stem	вещь
hawoda	unkn	вещь
hawā	unkn	работа
haz'ajstwo	unkn	хозяйство
hazajin	unkn	хозяин
haďil	unkn	ходил
haŋi	unkn	это
haŋkə	unkn	санки,нарта,нарты
haŋukta	unkn	спросить
haŋuktas	unkn	спросить.SLIP
haŋukti	unkn	спросить
haŋuktə	unkn	спросить
haŋār	stem	дыра
haŋāri	stem	дыра
haŋūkta	unkn	спросить
haŋūkča	stem	спросить
haŋə	unkn	следовать
hā	unkn	часть
hārī	unkn	разбудить
hd’e	unkn	где
he	unkn	ухо,ферма.SLIP
he:ki	unkn	старая.толстая.лиственница
hektə	unkn	ветка
heri	unkn	вырубать.жерди.для.чума
hēki	unkn	старая.толстая.лиственница
hēwun	unkn	свет
hi	stem	2SG
hi	unkn	SLIP,2SG
hig	unkn	ободрать,обдирать
higi	unkn	ободрать
hihur	unkn	???
hihə	stem	камень
hiki	stem	вымыть
hil'ba	unkn	указать
hila	unkn	обжарить.на.вертеле
hilba	stem	сообщить
hilba	unkn	сообщить
hilbə	unkn	сообщить
hilgi[n]	stem	дрожать
hilki	stem	мыть
hilki	unkn	стирать,мыть
hilkī	unkn	стирать
himiktə	unkn	брусника
himki	stem	кашлять
himulā	stem	тихий,молчать
himulā	unkn	молчать
himā	stem	быстрый
himūla	unkn	тихий,молчать
himūrga	stem	стихнуть
hin	stem	2SG
hin	unkn	трещать(об.огне).SLIP,2SG
hinda	unkn	удочка
hinčə	stem	PROB.ANGI
hinə	stem	2SG.ACC
hinə	unkn	2SG.ACC
hipkit	unkn	выследить
hipku	unkn	подговорить
hir	stem	разрезать.на.полосы
hirbā	stem	суп
hiri	unkn	доить
hirogir	unkn	Хирогир
hiru	unkn	бык.производитель
hitə	unkn	пустяк
hitə̄	unkn	чепуха
hitə̄n	stem	пустяк
hitə̄n	unkn	чепуха
hiwudak	unkn	скука
hiwur	SLIP	SLIP
hiŋilgən	unkn	снег
hiŋkəfkī	unkn	трещать(об.огне).SLIP
hiŋkərī	stem	трещать(об.огне)
hiŋn’ənə	unkn	жалкий{*}
hiŋīpču	unkn	жалкий
hiśi	stem	всунуть
hiγ	unkn	обдирать
hiγi	unkn	ободрать
hiγələhənī	unkn	осень(октябрь,ноябрь)
ho	unkn	SLIP,сильный(о.проявлении.качества),хочет.SLIP
hobd’o	unkn	веселье
hod'im	unkn	ходим
hodi	unkn	slip
hog	SLIP	SLIP
hog	unkn	большой.SLIP
hogdi	unkn	большой.SLIP,большой
hogdiŋa	unkn	большой
hogdiŋo	unkn	большой
hogdo	stem	хвост
hogdondo	stem	спина
hogdondo	unkn	спина
hogdoŋo	unkn	спина
hogdoŋә	unkn	спина
hoj	stem	тундра
hoj	unkn	тундра
hojo	unkn	лоб
hokor	unkn	потерять
hokori	stem	потерять
hokori	unkn	потерять
hokto	unkn	дорога
hoktə	unkn	дорога
hokūlgī	stem	согреть
holba	stem	красный
holba	unkn	красный
holbali	stem	покраснеть
holki	unkn	недавний
holtɨ	stem	навоз
hom=	unkn	медведь.SLIP
homoti	unkn	медведь
homoty	unkn	медведь
homōtī	unkn	медведь
homōti	unkn	медведь
homōtī	stem	медведь
hori	SLIP	нарочно.SLIP
horijən	stem	нарочно[як. "соруйан"]
horo	unkn	вершина
horogo	stem	Хорого(река)
horoki	unkn	глухарь
horokī	unkn	глухарь
horokī	unkn	глухарь
horol	unkn	кружиться
horolgon	unkn	поляна
horoli	stem	кружиться
horoli	unkn	вертеться,кружиться
horoľ	unkn	крутиться
horošo	unkn	хорошо
hot'	unkn	хоть
hot’	unkn	хоть
howohi	stem	вещи
howos	stem	вещи
hoč	unkn	хоть
hočət	unkn	хочет
hočətsa	unkn	хочется
hoďət	unkn	ходят
hoŋo	stem	плакать
hoŋo	unkn	плакать
hoť	unkn	хоть
hōm	unkn	закрыть.дверь
hoγorkī	stem	покрыться.наледью,наледь
hristin	unkn	Христина.SLIP
hristina	unkn	Христина
hristofor	unkn	Христофор
hs	unkn	SLIP
hu	SLIP	Лиса.SLIP
hu	stem	2PL
hu	unkn	ребенок.SLIP,SLIP,топор.SLIP,пилить.SLIP,дочь.SLIP
hub	stem	раздуть
huhegin	unkn	?начальница?
hujet	unkn	разойтись
huji	unkn	маленький
hujilōn	stem	маленький
huju	stem	маленький,кипеть
huju	unkn	маленький
hujukū	unkn	маленький
hujukūn	unkn	маленький
hujukō	unkn	самец
hujukū	stem	маленький
hujukū	unkn	маленький
hujukūn	stem	маленький
hujukūn	unkn	маленький
hujə	unkn	маленький,разойтись
hujət	unkn	разойтись
hukaptin	stem	предмет.для.вытирания?
hukačari	unkn	Хукочар
hukačarəf	unkn	Хукочаров
hukitə	stem	живот
hukitə	unkn	живот
huko	unkn	топор
hukti	stem	убежать
hukti	unkn	бежать(об.олене),бежать,убежать
huktiwu	unkn	ехать.на.оленях
huktə	unkn	ехать.на.оленях
huktɨ	stem	убежать
huku	unkn	отвернуться
hukulo	unkn	лежать
hukulō	stem	лечь
hukulō	unkn	лежать
hukulɒ̄	stem	лечь
hukulə	unkn	лечь
hukulə̄	stem	лечь
hukulə̄	unkn	лежать,лечь.SLIP,лечь
hukuši	unkn	поменять
hukśilla	stem	лыжа.камусная
hukə	stem	топор
hukə	unkn	топор
hul'u	unkn	маленький
hul	unkn	весь
hula	stem	оставить.за.собой
hula	unkn	упустить,оставить.за.собой
hulaki	stem	лиса
hulaki	unkn	лиса
hulakī	unkn	лиса
hulan	stem	Лиса
hulan	unkn	Лиса,лиса
hulda	stem	одеяло
hulda	unkn	одеяло
huldə	unkn	одеяло
huli	unkn	весь
huliŋ	stem	острый
hulu	stem	нагреться(о.воздухе),маленький
hulu	unkn	маленький
hulukun	unkn	маленький
hulān	stem	Лиса.VOC
hulī	stem	высушить
huləən	stem	Лиса.VOC
hul’u	unkn	маленький
hun	stem	верхняя.одежда,2PL
hun	unkn	SLIP,верхняя.одежда,2PL
hunati	unkn	девушка.дочь
huni	unkn	верхняя.одежда
hunti	unkn	другой
huntu	unkn	другой
hunā	unkn	пилить
hunāt	stem	девушка
hunāt	unkn	девушка,дочь.SLIP
hunāďi	stem	дочь
hunāďi	unkn	дочь
hunāďə	unkn	дочь.SLIP
hunŋtu	unkn	другой
hunə	stem	2PL.ACC
hunə	unkn	2PL.ACC
hupirō	unkn	куст
hupti	unkn	обогнать
huptɨ	stem	обогнать
huri	unkn	сиг
hurkoko	unkn	парень
hurkōkō	stem	парень
hurkōkō	unkn	парень
hurkōkōn	stem	парень
hurkōkōn	unkn	парень
huru	stem	пойти
huru	unkn	уйти,пойти.SLIP,идти,пойти
huruda	unkn	пойти.SLIP
hurukəw	unkn	пойти.SLIP
hurunən	unkn	медведица
hurur=	unkn	пойти.SLIP
hurī	stem	нырять
hurī	unkn	сиг
hurə	unkn	пойти.SLIP
huta	unkn	мешок
hutaka	unkn	мешок
hutakogir	unkn	Хутокогир
hute	unkn	ребенок.SLIP,ребенок
huto	unkn	ребенок
hutokogir	unkn	Хутокогир
hutōlə	unkn	прежде
hutə	stem	ребенок
hutə	unkn	slip,ребенок
hutə]	unkn	[ребенок]
hutә	unkn	ребенок
huwul	stem	весь
huwul	unkn	весь
huwuli	stem	весь
huwuli	unkn	весь
huču	stem	ткнуть
huďi	stem	судить
huńildə	stem	валяться
huńī	stem	дочь.STEM2
huŋi	unkn	хозяин
huŋni	stem	растянуть
huŋta	unkn	глубокий
huŋtu	stem	другой
huŋtu	unkn	другой
huŋtuki	unkn	другой
huśu	stem	ткнуть
huški	unkn	против
hā	stem	знать,часть
hā	unkn	часть,знать
hādončini	unkn	Хадончин
hādun	unkn	иногда
hāki	stem	печень
hākin	unkn	сахар
hālďa	unkn	стыдиться
hārgi	stem	Харги,черт
hārgi	unkn	Харги
hāŋi	unkn	следовать
hē	unkn	ухо
hēkta	stem	ива
hēkta	unkn	ива
hēkī	stem	старая.толстая.лиственница
hēlakī	unkn	куропатка
hēn	stem	ухо
hēr	unkn	построить[нет.в.словаре]
hēraŋ	stem	жердь
hēraŋi	stem	жердь
hērina	unkn	пойти.за.жердями
hēŋa	unkn	налим
hēŋan	unkn	налим
hī	stem	погасить
hī	unkn	желчь
hīt	[неясно]	[неясно]
hīw	SLIP	погасить.PASS.SLIP
hīγələ	unkn	зимой
hō	stem	сильный(о.проявлении.качества)
hō	unkn	SLIP,сильно,сильный,сильный(о.проявлении.качества),очень
hōgin	stem	пнуть
hōgintu	stem	пнуть
hōj	unkn	тундра
hōko	unkn	жара
hōksə	stem	кровь
hōksə	unkn	кровь
hōkāt	stem	хвастаться
hōkśu	unkn	кровь
hōlbarga	stem	покраснеть
hōm	stem	закрыть
hōna	stem	дымовое.отверстие
hōr	unkn	задохнуться
hōt	unkn	очень
hōwə	unkn	SLIP
hōwəl	unkn	SLIP
hōŋnā	stem	отрезать
hōγini	stem	пнуть
hōγintu	stem	пинать
hūkśinun	stem	на.лыжах
hūlla	unkn	одеяло
hūskī	stem	против
hūskī	unkn	обратно
hūśki	unkn	обратно
hə	unkn	SLIP,FOC,ну,нижний.SLIP
həbd’a	unkn	веселье
həbd’ānu	unkn	веселье
həg	unkn	SLIP,большой.SLIP
həgdi	stem	большой
həgdi	unkn	SLIP,большой{*},большой.SLIP,большой
həgdiha	unkn	вырасти
həgdihə	unkn	вырасти
həgdiŋo	unkn	большой
həgdiŋə	unkn	большой
həgdiγ	unkn	большой.SUP
həgdī	unkn	большой
həgdə	unkn	большой
həgdɨ	stem	большой
həgdɨ	unkn	большой
həgdɨ[???]	большой	большой
həgdɨŋə	stem	большой
həgər	unkn	устать
həhən	stem	рассказать
həhən	unkn	рассказать,рассказ
həhəni	stem	рассказать
həhəni	unkn	рассказать
həhənə	unkn	рассказать
həhəńi	stem	рассказать
həhəńi	unkn	рассказать
hək	unkn	SLIP
həktə	unkn	стелить,постелить
həkū	unkn	жара
həkū	stem	быть.горячим
həkūhī	stem	горячий
həkūl	stem	нагреться
həkə	stem	рассердить
həkə	unkn	рассердить
həkərgə	stem	обидеться
həkərgə	unkn	обидеться,рассердиться
həl	unkn	железо.SLIP
həlakī	unkn	куропатка
həlin	stem	спешить
həlinčə	stem	спешить
həlinśə	stem	спешить
hələ	stem	железо,вот
hələ	unkn	остаться,железо,ружье,вот
hələb	unkn	хлеб
hələj	stem	целый
hələkə	stem	остаток
hələkə	unkn	остаток
hənu	stem	догадаться
hənu	unkn	догадаться
hənŋə	stem	колено
hər	stem	внизу
hər	unkn	внизу
həraŋi	unkn	жердь
hərbin	stem	разделать[нет.в.словаре]
hərgiski	unkn	вниз
hərgīskī	unkn	вниз
hərgī	stem	низ,внизу
hərgī	unkn	низ
hərgīdō	stem	нижняя.сторона
hərgīdō=	unkn	низ.SIDE.SLIP
hərgīskī	stem	вниз
hərgīskī	unkn	вниз
hərgū	stem	нижний
hərgūldū	unkn	нижний.SLIP
həriwu	stem	разбудить
hərma	unkn	ферма
hərmi	unkn	??,типа.помочь
hərmə	unkn	ферма
həruki	unkn	беспокоить
hərī	stem	разбудить
hərə	stem	низ
hərək	stem	осторожный
hərəkǝ̄čə	unkn	достать.дно
hərəkə	stem	отдельный
hərəkə	unkn	отдельный,другой,другой(отдельный)
hərəlgə̄n	stem	низкая.долина
hərəso	unkn	хорошо
həti	unkn	сани
hətukə̄t	stem	ущипнуть
hətī	stem	женская.нарта
hətīlwi	unkn	женская.нарта.PL.ACC.RFL.SLIP
hətəkənə	unkn	очнуться
həwə	unkn	SLIP
həwəkī	stem	Бог
həwəkī	unkn	Бог
həwəkīdū=	SLIP	Бог.DATLOC.SLIP
həŋku	unkn	???
həŋkə	stem	слово,звук
həŋkə	unkn	слово,сказать
həŋkət	unkn	разговаривать,ругать
hə̄j	stem	INTJ
hə̄j	unkn	INTJ
hə̄kīmnə	stem	топтать
həγəni	unkn	рассказать
hәgdi	unkn	большой
hәlә	unkn	железо
hәrәki	unkn	беспокоить
i	stem	войти,и,INTER
i	unkn	рог.SLIP,все,стоять,куда.SLIP,SLIP,войти,вот,жить.SLIP,и,холод.SLIP
i[u]ŋtuwun	unkn	бубен
ibd’ari	unkn	родственник,родственник{*}
idu	unkn	где
iduk	stem	откуда
iduk	unkn	откуда
idū	unkn	где
idy	unkn	куда
idū	stem	где
idū	unkn	где
idəhəti	unkn	выбрать
idəhətisin	unkn	выбрать.SLIP
igarskojə	unkn	Игарское
igdɨ	stem	громкий
igi	stem	голос
igo	unkn	SLIP
igral'i	unkn	играли
igri	unkn	игры
ih	unkn	их
ihi	stem	достичь
ihi	unkn	достичь
ihī	unkn	достичь
ihə	unkn	камень
ije	unkn	рог
ijo	unkn	рог.SLIP,рог
ijolmotin	unkn	рог.PL.ACC.PS3PL.SLIP
ijuńa	unkn	июня
ijə	stem	рог
ijə	unkn	рог.SLIP,рог
ijəčəkō	unkn	рог.SLIP
ikon	unkn	грудная.клетка
iktu	unkn	бить
iktə	stem	ударить
iktə	unkn	ударить
iktә	unkn	зуб
ikō	stem	петь
ikō	unkn	петь
ikōn	stem	петь
ikə	stem	петь
ikəńi	unkn	песня
il'i	unkn	третий,или
il'makta	unkn	молодой
il	stem	встать
il	unkn	SLIP,встать,три.SLIP
ila	SLIP	зажечь.SLIP
ila	stem	зажечь,три
ila	unkn	[три,зажечь,куда,три,разжигать,разжечь
ilallalī	unkn	три.SLIP
ilan	stem	три
ilan	unkn	три
iland’ar	unkn	тридцать
ilani	stem	трое
ilani	unkn	трое
ilanďan	unkn	тридцать
ilanďar	stem	тридцать
ilanďar	unkn	тридцать
ilanī	unkn	трое
ilańi	unkn	трое
ilgu	unkn	???
ili	stem	третий,встать,или
ili	unkn	третий,встать,или
ilja	unkn	Илья
ilkə̄	unkn	затес
ilkə̄n	unkn	затес
ilkə̄ń	unkn	сделать.затесы
ilmakta	stem	молодой
ilmakta	unkn	молодой
ilməkta	unkn	молодой
ilo	unkn	куда
iltə	unkn	избавиться.от,миновать
iltəni	stem	миновать
ilā	stem	куда
ilā	unkn	куда
ilī	unkn	встать
ilō	stem	куда
ilō	unkn	куда
ilə	stem	человек,эвенк
ilə	unkn	эвенк,человек,куда
ilən	unkn	три
ilə̄	unkn	куда
ilә	unkn	эвенк,куда
im	unkn	им
imak	unkn	свежий
imurə̄	stem	жир
imurə̄n	stem	жир
imūksə	stem	жир
imūkśə	stem	жир
iməki	stem	свежий
in	stem	жизнь,жить
in	unkn	SLIP,жизнь,жить,жить.SLIP
inagda	unkn	иногда
ini	???	???
ini	stem	жизнь,жить
ini	unkn	жить,жить.SLIP
inim	stem	навьючить
iniw	unkn	навьючить
inkīčə	unkn	жизнь
inmə	stem	игла
inmək	stem	потакуй
inmək	unkn	торсук
inməka	unkn	торсука
inməki	stem	потакуй
inməki	unkn	торсук
inməkə	unkn	торсук
inna	unkn	Инна
innokentij	unkn	Иннокентий
ino[gda]	unkn	ино[гда]
inoŋi	unkn	день
institut	unkn	институт
instituti	unkn	институт
internat	stem	интернат
internat	unkn	интернат
internati	unkn	интернат
intɨ	stem	кормить.огонь
inwalit	unkn	инвалид
inī	unkn	нести.на.спине
inŋakta	stem	волос
inŋakta	unkn	волос,шерсть
inŋəni	unkn	день
inťərəsnaj	unkn	интересный
inə	unkn	смеяться,остановиться.на.короткое.время,жить
inək	unkn	остановиться.на.короткое.время.SLIP
iń	unkn	жить
in’	unkn	жизнь,жить.SLIP
in’oko	unkn	бабушка
in’ŋakta	unkn	шерсть
ir	stem	где
ir	unkn	где,жарить,шкура.SLIP,который,SLIP,Иркутский.SLIP
ira	unkn	Ира
iraxšo	unkn	шкура
irgi	stem	хвост
irgi	unkn	воспитывать,воспитать,вырастить,хвост
irgis'i	unkn	волк
irgiči	unkn	волк
irgičī	stem	волк
irgiśi	stem	волк
irgiši	unkn	припасы
irgišə	stem	продукты.на.дорогу
irgišə	unkn	припасы
irgī	stem	вырастить
irgī	unkn	воспитать,вырастить
irgīt	unkn	вырастить
irgəkta	unkn	овод
irgəktə	unkn	овод,паут
iri	stem	сварить
iri	unkn	сварить,варить
irina	unkn	Ирина
irkutskaj	unkn	иркутский,Иркутский
irtiki	unkn	куда
iru	unkn	тащить,везти
iruk	unkn	SLIP
irū	unkn	волочить
irī	unkn	варить
irə	SLIP	шкура.SLIP
irəks'ə	unkn	шкура
irəksə	stem	шкура
irəksə	unkn	шкура
irəktə	stem	лиственница
irəktə	unkn	лиственница
irəkśə	stem	шкура
irəkśə	unkn	шкура
irəkśəlwə	unkn	шкура.SLIP
irəkšə	unkn	шкура
irəmo	unkn	прийти.в.гости
irəmī	unkn	пойти.в.гости
irəmō	unkn	пойти.в.гости,прийти.в.гости
irə̄ksə	unkn	шкура
irə̄ktə	stem	лиственница
is'ə	unkn	видеть
is	stem	достичь
is	unkn	достичь,достигнуть,из,видеть
iskola	unkn	школа
ism’ińi	unkn	изменить,изменить.PL
ispalńajuśim	unkn	исполняющим
ispugalśa	unkn	испугался
issto	unkn	что
istado	unkn	стадо
istanok	unkn	станок
istanoki	unkn	станок
isə	stem	видеть
isə	unkn	видеть.SLIP,видеть
isət	unkn	видеть
is’ə	unkn	видеть
it'	unkn	SLIP
italija	unkn	Италия
itigā	stem	собираться
itiki	unkn	вещь
itiγā	unkn	собираться
ito	unkn	и.то
itti	unkn	идти
itə	unkn	дощечка.на.дно.лодки
itɨgā	stem	собираться
it’i	unkn	SLIP
ivan	unkn	Иван
ivanovič	unkn	Иванович
ivigin	unkn	Ивигин
iwan	unkn	Иван
iwanowič	unkn	Иванович
iwanowna	unkn	Ивановна
iwwas'	unkn	и.в.вос.SLIP
iz	unkn	из
izbuška	unkn	избушка
izbuškə	unkn	избушка
izda	unkn	сдать
izdat'ə	unkn	сдать
izdat	unkn	сдать
izredka	unkn	изредка
iče	unkn	увидеть
ičo	unkn	что
ičōw	unkn	SLIP
ičǝ	unkn	увидеть
ičə	stem	увидеть,видеть
ičə	unkn	SLIP,увидеть,видеть.SLIP,видеть
ičət	unkn	увидеть.SLIP,смотреть,увидеть.DUR.SLIP
ičətčə	unkn	slip
ičəw	unkn	увидеть.PASS.SLIP
ičəčəØm???	unkn	???
ičə̄	unkn	увидеть
iďi	unkn	иди
iďot	unkn	идет
iďoš	unkn	идешь
iľdə	unkn	тело
iľi	unkn	встать,стоять
iń	unkn	SLIP,жизнь,жить
ińi	unkn	жить
ińďə	unkn	жить.IPFV.SLIP
ińďək	unkn	жить.SLIP
ińīp	unkn	вьючить
ińīγə	unkn	развьючить
ińīγələ	unkn	развьючить.SLIP
ińə	stem	смеяться
ińəktə	stem	смеяться
iŋ	unkn	жить
iŋi	unkn	холод
iŋin	stem	холод
iŋin	unkn	холод
iŋini	stem	холод
iŋińi	unkn	похолодать
iŋə	unkn	мороз.SLIP
iŋəni	unkn	день
iśi	unkn	достичь
iśə	stem	видеть
iśə	unkn	видеть.SLIP,видеть
iśət	unkn	смотреть
iš'o	unkn	еще
iškola	unkn	школа
išo	unkn	еще
ī	unkn	и
īdū	unkn	где
īlā	unkn	куда
īlō	unkn	куда
iγin	unkn	шум
ja	unkn	я,SLIP,якут.SLIP,шаманить.SLIP
ja=	unkn	я
jablokə	stem	яблоко
jaja	stem	шаманить
jakov	unkn	Яков
jakow	unkn	Яков.SLIP
jakowlewna	unkn	Яковлевна
jakta	unkn	ручей
jakut	stem	якут
jakut	unkn	якут
jakutska	unkn	Якутск
jakutskaj	unkn	Якутия,Якутск
jamə	stem	яма
jantakī	unkn	росомаха
janwar	unkn	январь
japa	unkn	закопать
japә	unkn	закопать
jargidō	stem	журчать
java	unkn	Ява
jawa	unkn	Ява,яков
jazɨ	unkn	язык
jaŋ	unkn	гора
jaŋgu	unkn	говорить.SLIP,говорить
jaŋgōna	unkn	Янгона
jaŋgū	unkn	говорить
jaŋi	unkn	гора
jaŋu	stem	разговаривать,сломать
jaŋu	unkn	разговаривать
jaŋəti	unkn	лысый
jaša	unkn	Яша
jed’im	unkn	едем
jefimowič	unkn	Ефимович
jegor	unkn	Егор
jehe	unkn	Ессей
jehej	unkn	Ессей
jehejgon	unkn	SLIP
jehə	unkn	Ессей
jekō	unkn	якут
jekəndə	unkn	Эконда
jembiśimbə	unkn	Тембенчи
jermolajewna	unkn	Ермолаевна
jesli	unkn	если
jest	unkn	есть
jesť	unkn	есть
jewgenija	unkn	Евгения
jeśej	unkn	Ессей
ješ'o	unkn	еще
ješ’o	unkn	еще
jeγin	unkn	девять
jeγinďor	stem	девяносто
jigorəwiš’	unkn	Егорович
jist	unkn	есть
jist’	unkn	есть
jivo	unkn	его,как
jizdovih	unkn	ездовых
jiśo	stem	еще
jiśo	unkn	еще
jiš'o	unkn	еще,женщина
jiš'ō	unkn	еще
jišo	unkn	еще
jiš’o	unkn	еще
jo	unkn	испугаться.SLIP
joldigir	unkn	Елдыгир
jolk'i	unkn	FOC
jolki	unkn	EMPH
jolk’i	unkn	EMPH,FOC
jopu	unkn	жидкий
ju	stem	выйти
ju	unkn	выйти.SLIP,выйти
juga	unkn	юга
jugu	unkn	югу
juktə	stem	Юкта
jukələ	unkn	юкола
juridā	stem	засунуть
juďənō	stem	выйти[вежливая.форма]
južnoj	unkn	южный
jādantsəwi	unkn	Яданцев
jāku	stem	кричать
jējē	unkn	INTJ
jō	stem	удивиться
jō	unkn	испугаться
jō/γō	unkn	INTJ
jōkə	stem	кричать
jōkə	unkn	кричать
jōn	stem	удивиться
jōn	unkn	испугаться
jōni	unkn	удивиться
jū	stem	выйти
jū	unkn	выйти
jūkoŋi	stem	вьючное.седло
jūw	unkn	выйти.SLIP
jəgin	unkn	восемь,девять
jəginďar	unkn	девяносто
jəgor	unkn	Егор
jəhat'	unkn	ехать
jəhe	unkn	Ессей
jəhə	unkn	Ессей
jəkondə	unkn	Эконда
jəkəŋdə	unkn	Эконда
jəmbu	stem	расслабить,расслабленный
jənčəmbu	unkn	Енчембу
jərbəkə	stem	Ербогачен
jəsl'i	unkn	если
jəsli	unkn	если
jəst'	unkn	есть
jəśo	unkn	еще
jəš'o	unkn	еще
jəšo	unkn	еще
jə̄kə	unkn	кричать
jəγin	unkn	девять
jәgind’ar	unkn	девяносто
k	unkn	к,SLIP
ka	unkn	SLIP,каждый.SLIP
kabinətə	unkn	кабинет
kabutta	unkn	как.будто
kadrof	unkn	кадров
kadrovij	unkn	кадровый
kagda	unkn	когда
kahi	stem	сломаться
kahi	unkn	сломать,порвать
kaj	stem	загородить
kajur	unkn	каюр
kajə	unkn	противный
kak	unkn	как
kakbutto	unkn	как.будто
kakije	unkn	какие
kaknibut	unkn	как.нибудь
kakojito	unkn	какое.то
kakowə	unkn	какова
kaktə	unkn	как.то
kal	unkn	SLIP,один.из.парных.предметов.SLIP
kalan	stem	котел
kalan	unkn	котел,Калан
kalenə	unkn	колено
kalhos	unkn	колхоз
kalhoze	unkn	колхозе
kalhoznaj	unkn	колхозный
kali	stem	большой
kali	unkn	большой
kaliktivizatsiji	unkn	коллективизации
kalpašəfskij	unkn	Колпашевский,колпашевский
kaltaka	stem	один.из.парных.предметов
kaltalān	unkn	половинка.юрты
kaltɨr	stem	склон
kam	unkn	быстро
kama	unkn	SLIP
kamańa	unkn	скорей
kamaγā	unkn	несчастье
kamendant	unkn	комендант
kamnīkās	unkn	бежать.за.зверем
kamə	unkn	коммерсант.SLIP
kamərsa	unkn	коммерсант
kamərsanti	unkn	коммерсанты
kaməsar	unkn	коммерсант.SLIP
kan	unkn	FOC
kanešna	unkn	конечно
kanešnə	unkn	конечно
kanikul	unkn	каникулы
kanikuli	unkn	каникулы
kanskij	unkn	Канский
kanstant'inavna	unkn	Константиновна
kanstantin	unkn	Константин
kantora	unkn	контора
kanəts	unkn	конец
kanəšna	unkn	конечно
kapka	stem	капкан
kapka	unkn	капкан
kapkan	stem	капкан
kapkan	unkn	капкан
kapkannə	unkn	капкан.SLIP
kapu	stem	сломать
kapu	unkn	сломать
kar	unkn	как
karab'i	unkn	карабин
karab'in	unkn	карабин
karabin	stem	карабин
karabin	unkn	карабин
karab’in	unkn	карабин
karavan'ə	unkn	караване
karawan	unkn	караван
karija	unkn	замшевая.парка
karman	stem	карман
karman	unkn	карман
kartiška	unkn	карточка
kasir	unkn	кассир
kastelanša	unkn	кастелянша
kasudaj	unkn	шуметь
kataŋskij	unkn	Катангский
kato	unkn	slip
kator'im	unkn	которым
katoraja	unkn	которая
katorij	unkn	который
katoriji	unkn	которые
katorijə	unkn	которые
katoriə	unkn	которые
kat’a	unkn	Катя
kazahstani	unkn	Казахстан
kazak	unkn	казах
kačulin	unkn	шорох
kańešna	unkn	конечно
kaŋa	unkn	стругать
kaŋki	stem	быстрый,крепкий
kaŋkip	stem	закрепить
kaśi	unkn	щенок
kašuna	unkn	топать
každ	unkn	каждый.SLIP
každij	unkn	каждый
každom	unkn	каждом
každovo	unkn	каждого
kažitsa	unkn	кажется
kem	unkn	кем,FOC
keša	unkn	Кеша
khon??	unkn	?
ki	unkn	slip,лыжа.голица.SLIP,километр.SLIP
kiglo	unkn	лыжа.голица
kik	unkn	укусить
kiki	unkn	укусить
kikəči	stem	свистнуть
kilo	unkn	километр.SLIP
kilom'ətrə	unkn	километр
kilometr	unkn	километр
kilometra	unkn	километр
kilomətr	unkn	километр
kilomətər	unkn	километр
kiltɨrə̄	stem	провялиться
kiləba	unkn	хлеб
kiləbə	unkn	хлеб
kiləmetra	unkn	километр
kino	unkn	кино
kinəm’ihan’ik	unkn	киномеханик
kira	unkn	край
kiramki	unkn	острога
kiran	unkn	орел
kiraγit’	unkn	около
kirə	unkn	INTJ
kislakan	unkn	Кислокан
kislokan	unkn	Кислокан
kiŋgilə	unkn	колокольчик
kiŋgit	unkn	Кингит
kiγlo	unkn	лыжа.голица.SLIP
klara	stem	Клара
klas	unkn	класс.SLIP,класс
klasi	unkn	класс
klasə	unkn	класс
kl’ətka	unkn	клетка
kohi	unkn	косить
koj	unkn	заблудиться
koji	unkn	заблуждаться
kojәkak	unkn	кое.как
kokollo	stem	рукавица
kolabildi	unkn	Кола.Бельды
kolan	stem	Николай
kolhos	unkn	колхоз
kolhoze	unkn	колхозе
kolhoznaj	unkn	колхозный
kolhozof	unkn	колхозов
kolibəlka	unkn	колыбелька
kolobo	stem	хлеб
kolobo	unkn	хлеб
kolədž	stem	колледж
kom=	unkn	Комое.SLIP
komnata	unkn	комната
komojə	stem	Комое
konstantinowič	unkn	Константинович
kor	unkn	корь
kori	unkn	кори,корь
koridor	unkn	коридор
kormē	unkn	подол
korop	unkn	корова
korostɨ	unkn	коросты
korow	SLIP	SLIP
koročə	unkn	короче
korńi	unkn	корни
koso	unkn	мыс
kosol	unkn	мыс.SLIP
kosťa	unkn	Костя
kotira	stem	покоробиться
koto	stem	пальма
kotor	unkn	который
kotorij	unkn	который
kovo	unkn	кого
kowildi	unkn	поплавок
kowoto	unkn	кого.то
kočəvat	unkn	кочевать
koŋi	unkn	грызть,отгрызть
koŋko	unkn	стучать
koŋnomo	stem	черный
koŋnomo	unkn	черный
koγi	unkn	косить
kr'əpk'im'i	unkn	крепкими
krasnaja	unkn	Красная
krasnojarska	unkn	Красноярск
kraśiwaj	unkn	красивый
kraśiwaja	unkn	красивая
kraśiwəjə	unkn	красивее
kremlowskij	unkn	кремлевский
krepkaja	unkn	крепкая
kriglij	unkn	круглый
krimla	unkn	Кремля
kruškə	unkn	кружка
kto	unkn	кто
ku	unkn	SLIP
kuda	unkn	куда
kuhī	stem	воевать
kuji	unkn	подраться.SLIP
kujkī	stem	глухой
kujī	unkn	подраться
kukla	unkn	кукла
kukti	unkn	забраться,залезть
kultir	unkn	порог
kultiri	unkn	порог
kulumbē	unkn	Кулюмбе
kul’	unkn	куль
kumtə	stem	опрокинуть
kupa	unkn	купаться.SLIP
kuptu	stem	покрыть
kupču	unkn	теплое.место.для.ног
kuranək	unkn	все.время
kurupā	unkn	крупа
kurē	stem	огород
kurəles’im	unkn	куролесим
kurə̄	stem	огород
kusu	unkn	стружка
kuttajaha	unkn	Кутта.яха
kutu	unkn	удача
kuwrik	unkn	кубрик
kuŋa	unkn	ребенок.SLIP
kuŋak	unkn	ребенок.SLIP
kuŋaka	stem	ребенок
kuŋaka	unkn	SLIP,ребенок
kuŋaka=	stem	ребенок.SLIP
kuŋakan	unkn	ребенок
kuŋakani	unkn	ребенок
kuŋakār	unkn	дети
kuŋākā	unkn	ребенок
kuŋə	unkn	ребенок
kuŋəkа̄	unkn	ребенок
kuśi	unkn	биться
kūkti	unkn	залезть
kīk	stem	команда.отзыв.собаки
kīkə	unkn	свистеть
kōlar	stem	дернуться
kōrōwə	unkn	корова
kōtuj	unkn	Котуй
kōŋāktə	stem	колокольчик
kūktɨ	stem	забраться
kɔtuj	unkn	Котуй
kə	stem	давай,собираться,INTJ
kə	unkn	HORT,slip,SLIP,не.мочь,вот,INTJ
kəgda	unkn	когда
kəhə	unkn	мучиться
kək	unkn	как
kəkoj	unkn	какой
kəlaš	unkn	класс
kələ	stem	INTJ
kələ	unkn	INTJ
kələ̄	unkn	INTJ
kəl’eka	unkn	калека
kəmərof	unkn	комаров
kəməďisə	stem	шкодливый[нет.в.словаре]
kənstantinavna	unkn	Константиновна
kəp	SLIP	SLIP
kəpkani	unkn	капкан
kəpu	unkn	опухнуть
kəpə	stem	всплыть
kər	unkn	семья.SLIP
kərgin	unkn	семья
kərgə	stem	семья
kərgə	unkn	семья
kərgən	stem	семья
kərgən	unkn	семья
kərgəni	unkn	семья
kərim	unkn	белка
kərm’ilis’	unkn	кормились
kərə	stem	белка
kərəmīn=	unkn	белка.VBLZ.HUNT.SLIP
kərəmīďək=	unkn	белка.VBLZ.HUNT.SLIP
kər’asnəjarsk	unkn	Красноярск
kət	unkn	много.SLIP
kətə	stem	много
kətə	unkn	многий,много
kətə́	unkn	много
kətə̄	unkn	много
kəďū	stem	польза(якут.көдьүүс)
kəŋgilō	unkn	звенеть
kəŋgilōn	unkn	колокольчик
kəŋgilō	stem	колокольчик
kəŋgilə	unkn	колокольчик
kəŋginī	unkn	звенеть
kəŋginə	unkn	звенеть
kəšə	unkn	мучение
kəšə̄	unkn	мучение
kəγə	stem	мучение,мучиться
kəγə	unkn	мучиться
kəγə̄	unkn	мучиться
kаpka	unkn	капкан
kәhә	unkn	мучиться
kәkojtә	unkn	какой.то
kәrgәn	unkn	семья
k’inəm’ihn’ik	unkn	киномеханик
k’uŋ	unkn	SLIP
l'eto	unkn	лето
l'isi	unkn	лисы
l'ohkiji	unkn	легкие
l'ud'i	unkn	люди
l'uda	unkn	Люда
l'udm'ila	unkn	Людмила
l'ulka	unkn	люлька
l'ətn'ijə	unkn	летнее
l'ətom	unkn	летом
l'əžat	unkn	лежат
labas	unkn	лабаз
labazi	unkn	лабаз
ladno	unkn	ладно
lalbuka	unkn	мох
lambarā	stem	прилипнуть
lambarā	unkn	прилипнуть
lap	unkn	SLIP
lapami	unkn	лапами
lapta	unkn	лапта
laptu	unkn	лапта
lapča	unkn	рыбий.хвост
lapə	stem	лапа
lapə	unkn	лапа
latiši	unkn	латыши
lawādā	unkn	тащить
lawi	unkn	мох.SLIP
lawikta	unkn	мох
lawu	unkn	мох.SLIP
lawādāp	stem	нести(в.зубах)
laŋi	stem	распаковать
laŋi	unkn	распаковать,ловушка
lekarstwa	unkn	лекарство
lena	unkn	Лена
leningrat	unkn	Ленинград
lesnitsa	unkn	лестница
letə	unkn	лето
letəm	unkn	летом
leči	unkn	лечить
leši	unkn	лес
li	unkn	лишние.SLIP,ли
libgō	unkn	идти.(о.снеге),идти(о.снеге)
libgə̄	unkn	идти(о.снеге)
lihačow	unkn	Лихачев
lihťir	unkn	лихтер
lila	unkn	Лиля
limtɨ	stem	р.Илимпея
lipkī	stem	закупорить
listvenitsi	unkn	лиственницы
litajut	unkn	летают
lišniji	unkn	лишние
lišńivo	unkn	лишнего
ližah	unkn	лыжах
liži	unkn	лыжи
logī	stem	ругаться
loko	stem	повесить
loko	unkn	повесить
lokomī	unkn	летние.унты
lokomī	stem	летние.унты
lokoso	unkn	седло
loku	stem	повесить
lopoko	unkn	Лопоко
loporō	stem	выскочить
loporō	unkn	выскочить
lońa	unkn	Лёня
ložatsa	unkn	ложатся
lu	stem	смола
lu	unkn	смола
luboj	unkn	любой
luhu	stem	все.время
luhu	unkn	все.время
luhū	unkn	все.время
luk	stem	снять
luk	unkn	снять
luki	stem	снять
lukī	unkn	стрела
lupa	unkn	вонзить
lupaγo	unkn	вонзиться.SLIP
luporō	stem	пройти.насквозь
luporō	unkn	пройти.насквозь
lupū	unkn	пройти.насквозь
lurgi	stem	гореть
lusa	stem	русский
lusa	unkn	русский
luta	unkn	русский.SLIP
luča	stem	русский
luča	unkn	русский
luččo	unkn	лучше
lučšә	unkn	лучше
luŋurī	unkn	ночь
lūča	unkn	русский
lvom	unkn	Львом
lāŋ	unkn	ловушка
ləhčə	unkn	легче
ləningrat	unkn	Ленинград
ləpromhoz	unkn	леспромхоз
lərok	unkn	ларек
lət	unkn	летом.SLIP
lətn'iji	unkn	летние
lətn'im	unkn	летним
ləto	unkn	лето
lətom	unkn	летом
ləŋko	unkn	Лэнко,Лэнгко
l’	unkn	ль
l’es	unkn	лес
l’esu	unkn	лесу
l’eši	unkn	лес
l’ižat	unkn	лежат
m'ač	unkn	мяч
m'ača	unkn	мяча
m'ačik	unkn	1PL(EXCL),мячик
m'ačiki	unkn	мячик
m'ačəj	unkn	мячей
m'ińa	unkn	меня
m'ińat	unkn	менять
m'išok	unkn	мешок
m'ər'ə	unkn	просыпания.SLIP,мере
m'əs'atsa	unkn	месяца
m'əs'atsəf	unkn	месяцев
m'əsta	unkn	места
m'əsto	unkn	место
ma	unkn	закончить.SLIP,SLIP
magazi	unkn	магазин
magazin	stem	магазин
magazin	unkn	магазин
magda	unkn	SLIP
magl'i	unkn	могли
mahəm	unkn	махом
maj	unkn	май
maja	unkn	моя
majgu	unkn	ленок,линок
makarič	unkn	Макарович
mal'en'ka	unkn	маленько
malad'iji	unkn	молодые
malas	unkn	закончить.SLIP
malenečko	unkn	маленечко
malenkowo	unkn	маленького
maleńko	unkn	маленько
malij	unkn	малое
malinkij	unkn	маленький
malo	unkn	мало
malū	stem	место.напротив.входа
mal’en’ko	unkn	маленько
mana	stem	лапа,закончить
mana	unkn	кончить,закончить.SLIP,закончить
manahow	unkn	Монахов
manaw	unkn	закончить
mandr’i	unkn	крепкий
manu	unkn	закончить
mara	stem	завязка.торсука
mari	unkn	марник,кустарник
marija	unkn	Мария
maris	unkn	Марис
mart	stem	март
martə	unkn	март
marudəlī	unkn	???
maršruti	unkn	маршрут
maskovskoj	unkn	московской
maslo	stem	масло
mat'	unkn	мать
mat'iriala	unkn	материала,
mata	unkn	согнуть
matematika	unkn	математика
mauti	unkn	аркан
mazlo	unkn	масло
maŋa	stem	твердость
maša	unkn	Маша
medl	unkn	slip
medśistra	unkn	медсестра
meratsa	unkn	меряться
mere	stem	мера
mesto	unkn	место
metri	unkn	метр
metrow	unkn	метров
metrə	stem	метр
metər	stem	метр
metəri	unkn	метр
meśats	unkn	месяц
meśatsə	unkn	месяце
mi	unkn	мы
migdi	unkn	шуметь
migdin	unkn	шуметь
mihajil	unkn	Михаил
mihajlowna	unkn	Михайловна
mihanik	unkn	механик
mikčan	stem	прыгнуть
mikčan	unkn	прыгнуть
mikčanə	stem	прыгнуть
mikčān	unkn	прыгнуть
mikčān	unkn	прыгнуть
militsija	unkn	милиция
min'a	unkn	меня
min	stem	1SG
min	unkn	1SG,PS1SG
mindu	unkn	1SG.SLIP
mini	unkn	1SG.SLIP
minŋī=	SLIP	1SG.PROPR.SLIP
minə	stem	1SG.ACC
minə	unkn	1SG.ACC,порезать
minә	unkn	1SG.ACC
miri	unkn	выйти.замуж
mirnɨj	stem	Мирный
mirə	stem	февраль,выйти.замуж
mirə	unkn	жениться,выйти.замуж
mirən	unkn	жениться
mirəni	stem	выйти.замуж
mirə̄n	unkn	выйти.замуж
mis	unkn	мыс
mit	stem	1PL(INCL).DUAL
mit	unkn	1PL(INCL),1PL(INCL).DUAL
mińa	unkn	меня
mladšii	unkn	младший
mlačšij	unkn	младший
mm	unkn	мм,HES
mmm	unkn	ONOM
mn'ə	unkn	мне
mnogo	unkn	много
mnoj	unkn	мной
mo	stem	RFL
mo	unkn	дерево.SLIP,SLIP,RFL.SLIP,может.SLIP,RFL,дерево
mogila	unkn	гроб
moh	unkn	мох
moha	stem	лес
moha	unkn	лес
mokura	unkn	умереть
molda	stem	вырубать.доски
molda	unkn	вырубать.доски
moli	unkn	SLIP
moliśi	stem	молиться
molī	unkn	молиться
momondo	stem	Момондо
mon	stem	RFL
mon	unkn	RFL,RFL.SLIP
moni	stem	RFL
moni	unkn	RFL
monŋi	unkn	разминать
mor	unkn	мор
morta	unkn	бороться
moskwa	unkn	Москва
moti	stem	лось
moti	unkn	лось
motor	unkn	мотор
moŋ	unkn	SLIP
moŋnī	unkn	размять
moš	unkn	может,может.SLIP
mož	unkn	можжевельник.SLIP
možit	unkn	может
možno	unkn	можно
možət	unkn	может
mō	unkn	дерево
mōn	unkn	RFL
mōni	unkn	RFL
mōtī	unkn	лось
mōtī	unkn	лось
moγa	unkn	лес
mu	unkn	SLIP,вода,1PL(EXCL),конец.SLIP
muda	unkn	конец
mudani	unkn	конец
muhu	stem	дух
mujə	unkn	край
mukta	unkn	Мукто
muktə	unkn	Муктэ
muku	unkn	муку
mukura	unkn	умереть
mukurā	unkn	умереть
mukurə	stem	умереть
mukōto	stem	задний.проход
mukətə	stem	задний.проход
mukə̄tə	stem	задний.проход
muldi	unkn	не.уметь
muldī	unkn	не.уметь
mumŋət	unkn	напрямик
mun	stem	1PL(EXCL)
mun	unkn	1pl.excl,1PL(EXCL)
mundrukan	unkn	заяц
munduka	stem	заяц
munduka	unkn	заяц
mundukan	stem	заяц
mundukā	unkn	заяц
muntiki	unkn	1PL(EXCL).ALL
munńaki	unkn	собрание
munə	stem	1PL(EXCL).ACC
munə	unkn	1PL(EXCL).ACC
muru	unkn	обернуться
muruktə	unkn	Мурукта
murūkə̄	unkn	обойти
murūkə̄	stem	бродить.вокруг
murəγə	stem	вокруг
musan	unkn	вернуться
musu	unkn	вернуться
musān	unkn	вернуться
musāni	unkn	вернуться
mut	stem	1PL(INCL)
mut	unkn	1PL(INCL),1PL(EXCL)
muzəj	unkn	музей
muču	stem	вернуться
muču	unkn	вернуться
mučū	unkn	вернуться
muŋga	unkn	засмолить
muŋūri	unkn	чир
muśan	stem	вернуться
muśu	unkn	вернуться
mušən’jə	unkn	мученье
mužəm	unkn	мужем
mū	unkn	вода
my	unkn	мы
māta	unkn	сосед
mēl	stem	проснуться
mēl	unkn	проснуться
mēwa	stem	сердце
mēwan	stem	сердце
mēwani	stem	сердце
mēwut	stem	рассердиться
mēwuśi	stem	рассердиться
mēwū	unkn	рассердиться
mō	SLIP	SLIP
mō	stem	RFL,дерево
mō	unkn	палка,RFL,дерево
mōha	stem	лес
mōl	unkn	SLIP
mōla	unkn	готовить.дрова
mōlkə	stem	померещиться(о.призраке)
mōloro	unkn	[перевод неясен]
mōn	stem	RFL
mōn	unkn	RFL
mōni	stem	RFL
mōni	unkn	RFL
mōr	unkn	RFL.PL
mōtī	unkn	лось
mōtīt	unkn	лось.CHILD.SLIP
mōty	unkn	лось
mōtī	stem	лось
mōtī	unkn	лось
mōγa	unkn	лесок
mū	stem	вода
mū	unkn	вода
mūdə̄	unkn	разливаться
mɔni	unkn	RFL
mə	stem	RFL
mə	unkn	RFL
mədə	unkn	почувствовать
məlen’kə	unkn	маленько
məl’en’kə	unkn	маленький
mən	unkn	SLIP,RFL,RFL.SLIP
məni	unkn	RFL
mənmaktə	unkn	комар
mərgə	stem	опечалиться
məskwa	unkn	Москва
məsto	unkn	место
mətrika	unkn	метрика
mətəorit	unkn	метеорит
məľčō	unkn	попасть
mə̄	stem	RFL
mə̄	unkn	RFL
mə̄mə̄gīl	stem	друг.друга
mə̄mə̄gīlwər	stem	друг.друга
mə̄n	unkn	RFL
mə̄ni	stem	RFL
mə̄ni	unkn	RFL
mə̄nin	unkn	сам
mə̄nŋī	unkn	размять
mə̄r	unkn	RFL.PL
mə̄wan	unkn	сердце
m’estǝ	unkn	место
m’est’i	unkn	месте
m’ińaji	unkn	менять
n'egi	unkn	нижний
n'i	unkn	не
n'id'əl'a	unkn	неделя.SLIP,неделя
n'uhat’	unkn	нюхать
n'ə	unkn	не
n'əkotoriji	unkn	некоторые
n'əskol'ko	unkn	несколько
n	unkn	SLIP
na	unkn	SLIP,положить,нарты.SLIP,седьмой.SLIP,на
naberi	unkn	набери
nada	stem	надо
nada	unkn	надо,семь
nadan	stem	семь
nadan	unkn	семь
nadanďar	unkn	семьдесят
nadej	unkn	надеяться
nadi	unkn	семь,седьмой
nado	stem	надо
nado	unkn	надо
nadojə	unkn	надоесть
nagružajim	unkn	нагружаем
nai	unkn	жердь.для.остроги
najabr'	unkn	ноябрь
najabr'a	unkn	ноября
nakanna	unkn	Наканно
nakanno	stem	Наканно
nakanno	unkn	Наканно
nalnət	unkn	меняться?
nalot	unkn	налет
nam(ū)	unkn	сложить
nama	unkn	седло,тепло,навьючить
namarniki	unkn	напарник
namaru	stem	прилепить
namasə	unkn	седло
namā	stem	прилепить
namāďi	unkn	сто
nam’is’a	unkn	важенка
nanmakta	unkn	комар
nannat	unkn	SLIP
nap	unkn	напугал.SLIP
naparnik	unkn	напарник
naparniki	unkn	напарник
napisyvali	unkn	написывали
napr'im'ər	unkn	например
napr	unkn	например.SLIP
napri'imər	unkn	например
naprotif	unkn	напротив
naptara	unkn	лечь.плашмя
napugal	unkn	напугал
nariliska	unkn	Норильск
narilska	unkn	Норильск
naroda	unkn	народа
narot	unkn	народ
nas	unkn	нас
nastupajit	unkn	наступает
natari	unkn	нарты
nataša	unkn	Наташа
naval'ilə	unkn	навалил
navernаə	unkn	наверное
navərno	unkn	наверное
navərnojə	unkn	наверное
navərnoə	unkn	наверное
naw'ərnə	unkn	наверное
nawerna	unkn	наверное
nawernəje	unkn	наверное
nawu	unkn	обидеться
nawəh	unkn	навес
nawəhi	unkn	навес,навес.SLIP
naz	unkn	SLIP
nazat	unkn	назад
nazawtra	unkn	назавтра
nazivajits'a	unkn	называется
nazyvajut	unkn	называют
nazɨwalsato	unkn	назывался.то
načal	unkn	начал
načali	unkn	начали
načalito	unkn	начали.то
načalnik	unkn	начальник
načalniki	unkn	начальник
načal’nik	unkn	начальник
načinajim	unkn	начинаем
načəvat’	unkn	ночевать
naďožni	unkn	надежный
naš	unkn	SLIP
naərnə	unkn	наверное
ne	unkn	не
nekotori	unkn	некоторый.SLIP
nekotorij	unkn	некоторый
nelki	unkn	настать(о.весне)
nemtsə	unkn	немец
net	unkn	нет
netu	unkn	нет
nevodit'	unkn	неводить
nevəďili	unkn	нéводили
newəďe	unkn	невод
ni	unkn	ни,кто,не
ni=	unkn	Нидым.SLIP
nidim	unkn	Нидым
nidələ	unkn	неделя
nih	unkn	них
nikalajəvič	unkn	Николаевич
nikolaj	unkn	Николай
nikolajewič	unkn	Николаевич
nikolajiš’	unkn	Николаевич
nikə	unkn	собираться
nikəkoj	unkn	никакой
nim	unkn	ним
nimńākān	unkn	сказка
nimŋa	stem	шаманить
nimŋakān	stem	сказка
nimŋakān	unkn	сказка
niru	unkn	хариуз
nix	unkn	них
nix?	unkn	них
ničəvo	unkn	ничего
nī	unkn	кто
no	None	но
no	unkn	но,SLIP,положить
nog'i	unkn	ноги
nojabr’	unkn	ноябрь
nokun	unkn	младший.сиблинг
nono	stem	сначала
nono	unkn	начать
nonon	stem	сначала
nonon	unkn	сначала,прежде
nor	unkn	SLIP
norma	unkn	норма
novijgot	unkn	Новый.год
nočjə	unkn	ночью
noŋńə	unkn	настать(о.весне)
nō	unkn	положить
nu	RUS	ну
nu	stem	ну
nu	unkn	но,SLIP,Ну,INTJ,ну,ну.SLIP
nul'iwoj	unkn	нулевой
nul	unkn	зажечь.лампу,кочеват ь.SLIP,кочевать.SLIP
nulgi	stem	кочевать
nulgi	unkn	кочевка,кочевать
nulgildəwəl	unkn	кочевать.SLIP
nulgimmm	unkn	SLIP
nulgī	stem	кочевать
nulgī	unkn	кочевать,аргиш,аргишить
nulgīktəwur	unkn	SLIP?
nuliwoj	unkn	нулевой
nurgi	stem	сгореть
nurgi	unkn	сгореть
nurma	unkn	подкрасться
nuŋa	stem	3SG
nuŋa	suffix	3PL
nuŋa	unkn	3SG,3PL
nuŋan	SLIP	SLIP
nuŋan	stem	3SG
nuŋan	unkn	3SG
nuŋandar	unkn	шестьдесят
nuŋanmə̄n	unkn	3SG.ACC
nuŋar	stem	3PL
nuŋar	unkn	3PL{*},3PL.SLIP,3PL
nuŋarduk	unkn	SLIP
nuŋardū	unkn	3PL.DATLOC.SLIP
nuŋari	unkn	3PL
nuŋartin	stem	3PL
nuŋartin	unkn	3PL
nuŋartyn	unkn	3PL
nuŋartɨn	stem	3PL
nuŋi	unkn	шестой
nuŋun	unkn	шесть
nuŋəmə̄n	unkn	3SG.ACC
nuŋən	unkn	3SG
nuŋəndūn	unkn	3sg.datloc
nuŋənmə̄n	unkn	3SG.ACC
nuŋənmə̅n	unkn	он.ACC
nā	unkn	попасть
nādan	unkn	семь
nārtə	unkn	ручная.нарта
nāŋmakta	unkn	комар
nădajela	unkn	надоело
nō	stem	положить
nō	unkn	положить
nōda	stem	бросить
nōda	unkn	бросить
nōdu	stem	бросить
nōdu	unkn	бросить
nōduγa	stem	бросить
nōdā	stem	бросить
nōdā	unkn	оставить
nōdə	stem	хорошо
nōdə	unkn	хорошо
nōdа̄	unkn	бросать
nōki	unkn	лабаз
nōku	unkn	лабаз
nōnon	unkn	сначала
nə	unkn	SLIP,положить,не,на
nəbral’i	unkn	набрали
nəkni	unkn	младший.сиблинг.PLSTEM,младший.сиблинг
nəku	unkn	младший.сиблинг
nəkun	stem	младший.сиблинг
nəkun	unkn	младший.сиблинг
nəkuni	unkn	младший.сиблинг
nəkunmif	unkn	SLIP
nəkunninmi	SLIP	младший.сиблинг.COM.RFL.SLIP
nəkū	unkn	младший.сиблинг
nəkū	unkn	младший.сиблинг/племянник
nəkūn	unkn	младший.сиблинг
nəkūni	unkn	младший.сиблинг
nəkə	stem	собираться
nəkə	unkn	собираться
nəlgə	unkn	коряга
nəlki	stem	весной
nəlki	unkn	весной
nəmkū	unkn	тонкий
nəptalə	unkn	гладкий
nəčal’i	unkn	начале
nəŋə	stem	молиться,жаловаться.в.суд
nəŋə	unkn	идти
nə̄	unkn	положить
nə̄ku	unkn	лабаз
nə̄l	unkn	весной.SLIP
nə̄lkī	unkn	весной
ńān	unkn	опять
ńәkә	unkn	собираться
nәku	unkn	младший.сиблинг
nәkuni	unkn	младший.сиблинг
nәkunə	unkn	младший.сиблинг
nәkunә	unkn	младший.сиблинг
n’anmakta	unkn	комар
n’ekudə	unkn	некуда
n’i	unkn	ни
n’on’o	unkn	мать
n’orma	unkn	норма
n’ulgi	unkn	кочевать
n’umu	unkn	ослабеть(об.органе)
n’umun	unkn	шесть.SLIP
n’uŋi	unkn	шестой
n’uŋun	unkn	шесть
n’ədāvnə	unkn	недавно
n’əkə	unkn	собираться
o	SLIP	SLIP
o	stem	сделать,стать
o	unkn	сделать,стать.SLIP,стать,прийти.SLIP,сделать.SLIP,олень.SLIP,о,SLIP,INTJ,NEG,а,когда.SLIP
obazatelno	unkn	обязательно
obeda	unkn	обед
oblast’	unkn	область
obligatsə	unkn	облигация
obokō	unkn	старшая.сестра/мать.родителя
obrazom	unkn	образом
obš'əm	unkn	общем
obšəm	unkn	общем
od'a	unkn	беречь
odgi	unkn	много
odnoj	unkn	одной
ofśanki	unkn	овсянка
ogdi	unkn	много
ogdiŋo	unkn	много,большой
ogdokō	unkn	парка.с.шерстью
ogo	unkn	срубить
ogorot	stem	огород
ograda	unkn	ограда
oh	unkn	SLIP,INTJ
oha	unkn	камыс
oho	SLIP	SLIP
ohota	unkn	охота
ohotilśa	unkn	охотился.RUS
ohotit	unkn	охотиться
ohotnik	unkn	охотник
ohotniki	unkn	охотник
ohoto	unkn	охота
ohočus	unkn	охочусь
ohī	unkn	искра
ohōta	unkn	охота
oj	INTJ	INTJ
oj	unkn	INTJ,ой,олень.SLIP
oji	stem	наверху
oji	unkn	наверху
ojjojoj	INTJ	INTJ
ojo	SLIP	SLIP
ojo	stem	вершина
ojo	unkn	вершина,верхняя.часть
ojogir	unkn	Оёгир
ojon	unkn	течь
ojōkī	stem	по.течению
ojōkī	unkn	по.течению,вниз.по.течению
ojōn	stem	течь
ok	unkn	SLIP
oki	unkn	сколько,когда.SLIP
okin	unkn	сколько,когда
okolo	unkn	около
oksu	unkn	торопиться
okt’abr’	unkn	октябрь
ol'en'am	unkn	оленям
ol	unkn	SLIP,рыба.SLIP
oldo	stem	рыба
oldo	unkn	бок,рыба,рыба.SLIP,хороший
oldon	stem	крюк
oldon	unkn	бок
oldō	unkn	рыба
oleksā	unkn	Алекса
oleńiwodi	unkn	оленевод
olga	unkn	Ольга
olgo	unkn	высохнуть,сухой
olgī	stem	высушить
olgī	unkn	сушить,высушить
olgīt	SLIP	высушить.SLIP
olkə	unkn	еще
ollo	stem	рыба
ollo	unkn	рыба,бок
olo	stem	вздрогнуть.испугаться
olo	unkn	весь
olofśī	unkn	неожиданный
oloki	unkn	санки
olokoši	unkn	ранее
oločimŋu	unkn	???
olro	unkn	рыба
olənə	unkn	оленевод.SLIP
oləńiwodi	unkn	оленевод
oləńəwodi	unkn	оленевод
oləńəwot	unkn	оленевод
ol’ən’iwod	unkn	оленевод
om	unkn	SLIP
omiki	stem	голодный
omkə	unkn	люлька
omo	unkn	прийти,SLIP,оставить,приехать
omol	unkn	прийти.SLIP
omolg	unkn	сын.SLIP
omolgī	stem	сын
omolgī	unkn	сын,юноша
omošənŋə	unkn	SLIP
omŋo	stem	забывать
omŋo	unkn	забывать,забыть
omō	unkn	оставить
omōn	unkn	оставить
on	stem	он,как
on	unkn	он,как
ondə	unkn	SLIP
ono	unkn	оно,SLIP,пойти.искать.оленей
onə	stem	как
onə	unkn	искать.оленей,пойти.искать.оленей
on’ō	unkn	вышивать
opat	unkn	опять
opať	unkn	опять
opernij	unkn	оперый
opet	stem	опять
opet	unkn	опять
opiti	unkn	опыт
opkorō	stem	сухостой
opti	unkn	засыпать
opət	unkn	опять
op’at’	unkn	опять
or	unkn	олень.SLIP
ord’in	unkn	орден
ori	stem	звать
ori	unkn	звать,позвать
orlovo	unkn	Орлово
oro	stem	олень
oro	unkn	SLIP,олень,олень.SLIP
orolo	unkn	олень.SLIP
oron	stem	олень
oron	unkn	олень,[олень
oroni	unkn	олень
ororguru	unkn	SLIP
oros	unkn	прогнать
orī	unkn	позвать
orīl	unkn	позвать.SLIP
orə	unkn	кричать
os'in	unkn	осень
osin’	unkn	осень
osložńenijə	unkn	осложнение
osložńeńijə	unkn	осложнение
osnownojə	RUS	основное
osoγon	unkn	бурелом
ostal'is'	unkn	остались
ostehondroz	unkn	остеохондроз
ostol	stem	стол
os’in’jə	unkn	осенью
ot	unkn	от
otkaziwat	unkn	отказывать
oto	unkn	не.стать,не.стать.SLIP
otojo	unkn	стеречь
otorwal	unkn	оторвал
otpuska	unkn	отпуск
otrostki	unkn	отростки
otsa	unkn	отца
owudi	unkn	овод
ozəro	unkn	озеро,Озеро
očeń	unkn	очень
očən	unkn	очень
očəstwa	unkn	отчество
oďo	unkn	пожалеть
oďo=	unkn	пожалеть.SLIP
ońo	unkn	вышивать
ońōko	stem	бабушка
oŋki	unkn	NEG.SLIP
oŋko	stem	пастись
oŋko	unkn	пастбище
oŋnoko	unkn	теленок.до.года,теленок
oŋo	unkn	нос.лодки
oŋokto	stem	нос
ośeń	unkn	осень
oši	unkn	сейчас
ošo	unkn	NEG.SLIP
ošoloki	unkn	вверх.по.течению
ō	unkn	сделать,стать,делать,это,HES
ōj	unkn	ой
ōkin	unkn	когда
ōkī	unkn	сколько
ōn	unkn	как
oγikta	stem	коготь
p'atdiśat	unkn	пятьдесят
p'atij	unkn	пятый
p'atnatsatovo	unkn	пятнадцатого
p'atəji	unkn	пятая
p'ervyj	unkn	первый
p'ir'i	unkn	перевозили.SLIP
p'ir'idv'ižənija	unkn	передвижения
p'ir'iwoz'l'i	unkn	перевозили
p'ərvom	unkn	первом
p'əďəśat	unkn	пятьдесят
p	unkn	SLIP
pa't	unkn	пять
pa	unkn	SLIP,потом.SLIP,по,мере
padašli	unkn	подошли
padārək	unkn	подарок
padjom	unkn	подъем
padrat	unkn	подряд
padrosših	unkn	подросших
padv'ila	unkn	подвела
padv'ili	unkn	подвели
paewenkijski	unkn	по.эвенкийски
paharońen	unkn	похоронен
pahoži	unkn	похожи
pahəronkə	unkn	похоронка
pajəst'	unkn	поесть
pak=	unkn	SLIP
paka	unkn	пока
paktorija	unkn	фактория
pakušat'	unkn	покушать
pala	unkn	SLIP
palasa	unkn	полоса
palatka	stem	палатка
palatka	unkn	палатка
palatki	unkn	палатки,
palatkə	unkn	палатка
palawinu	unkn	половину
palets	unkn	палец
palmoj	unkn	пальмой
palno	unkn	полно
palok	unkn	палок
palučals'a	unkn	получался
pal’namošiniji	unkn	уполномоченный
pam'in'at'	unkn	поменять
pamośnik	unkn	помощник
pankagir	unkn	Панкагир
pankagiri	unkn	Панкагир
pankagirskaj	unkn	паңагирский
pankagirskəj	unkn	панкагирский
papal	stem	попасть
papal	unkn	попасть
para	unkn	пара
parawadńik	unkn	проводник
paruskamu	unkn	по.русскому
paruski	unkn	по.русски
pas'olk'ə	unkn	поселке
pas'olok	unkn	поселок
pas'oloki	unkn	поселок
pas	unkn	постоянного.SLIP
pasl'ədn'ij	unkn	последний
paslednij	unkn	последний
paslədnij	unkn	последний
paslədnəjə	unkn	последнее
pasmotr'im	unkn	посмотрим
paso’lok	unkn	поселок
pasporta	unkn	паспорт
pastajanava	unkn	постоянного
pastajanna	unkn	постоянно
pasti	unkn	пасти
pastroit'	unkn	построить
pastrojat	unkn	построят
pastrojit'	unkn	построить
pastuhi	unkn	пастушить
pastuk	unkn	пастух
pastuki	unkn	пастух
patamu	unkn	потому.SLIP,потому
patamušta	unkn	потому.что
patamušto	unkn	потому.что
patihon'ku	unkn	потихоньку
patom	stem	потом
patom	unkn	потом
paton'šə	unkn	потоньше
patpəvali	unkn	подпевали
patron	stem	патрон
patsarapal	unkn	поцарапал
pau	unkn	SLIP
pawlyš’	unkn	Павлович
pawre	unkn	повредил.SLIP
pawəl	unkn	Павел
pačotnij	unkn	почетный
pačťi	unkn	почти
pačťišta	unkn	почти.что
paśolk'ə	unkn	поселке
paśolka	unkn	поселок
paťiďiśat	unkn	пятьдесят
paťiďiśatiji	unkn	пятидесятые
paətamu	unkn	поэтому
paəvənkijski	unkn	по.эвенкийски
paəwənkijski	unkn	по.эвенкийски
pedučilišə	unkn	педучилище
pekarńa	unkn	пекарня
pel’onkə	unkn	пеленка
pensianәri	unkn	песионер
pensija	unkn	пенсия
pensijə	unkn	пенсия
penśianərka	unkn	пенсионерка
penśijə	unkn	пенсия
penśińər	unkn	пенсионер
pere	unkn	SLIP
peredowik	unkn	передовик
pereiminowat	unkn	переименовать
perekat	unkn	Перекат
perestrojka	unkn	перестройка
pervyj	unkn	первый
perwij	unkn	первый
pesoki	unkn	песок
peteu	unkn	ПТУ
pewets	unkn	певец
pečki	unkn	печки
pešera	unkn	пещера
pilaramə	unkn	пилорама
pirivot	unkn	перевод
pismō	unkn	письмо
pitəmək	unkn	Питемек
plan	unkn	план,вот
plem’aniki	unkn	племяник
pleči	unkn	плечи
ploho	unkn	плохо
plohoj	unkn	плохой
plot	unkn	плот
plәhoj	unkn	плохой
po	unkn	после.SLIP,попасть.SLIP,по
podārək	unkn	подарок
podgotofkə	unkn	подготовке
podpisyvali	unkn	подписывали
podwodi	unkn	подводить
podwodī	unkn	подводить
podwoďi	unkn	подводить
pogrip	unkn	погреб
pohwalnij	unkn	похвальный
pojəzda	unkn	поезд
poktorija	unkn	фактория
pol	unkn	пол
poligus	unkn	Полигус
polmeśatsa	unkn	полмесяца
polno	unkn	полно
položila	unkn	положила
poluš'i	unkn	получить
polzoval'is'	unkn	пользовались
pomniť	unkn	помнить
pomńu	unkn	помню
pop	unkn	поп
popal	stem	попасть
popali	stem	попасть
popali	unkn	попасть
popi	unkn	поп
por	unkn	пор
poroh	unkn	порох
porok	unkn	порог
poruh	unkn	порох
posl'ə	unkn	после
poslədnij	unkn	последний
posl’ə	unkn	после
potap	unkn	Потапово,потапово
potom	unkn	потом
potomu	unkn	потому
powar	unkn	повар,поварить
powreďil	unkn	повредил
počta	unkn	почта
pońali	unkn	поняли
pośōlok	unkn	поселок
pr'ama	unkn	прямо
pr'amo	unkn	прямо
pr'atki	unkn	прятки
pr'ihaďilaś	unkn	приходилось
pr'in'imajit	unkn	принимает
pr'išol	unkn	пришел
pr	unkn	продукт.PL
pra	SLIP	SLIP
pra	unkn	SLIP
pradukti	unkn	продукты
pradukty	unkn	продукт
praduktə	unkn	продукт
praduktəw	unkn	продуктов
praf'iśianal	unkn	профессионал
praf'iśianalnij	unkn	профессиональный
prajəzd'ims'a	unkn	проездимся
pramhos	unkn	промхоз
pramo	unkn	прямо
prasipan'ija	unkn	просыпания
prasnuls'a	unkn	проснулся
prastɨl	RUS	простыл
praučilśa	unkn	проучился
pravaj	unkn	правой
prawalilsa	unkn	провалился
prawaliwatsa	unkn	проваливаться
prawda	unkn	правда
prawiťelstwo	unkn	правительство
prawoj	unkn	правой
prezid’ənt	unkn	президент
pri	unkn	SLIP
prid'ots'a	unkn	придется
priihət’	unkn	приехать
prije	unkn	slip
prijehali	unkn	приехали
prijəhat'	unkn	приехать
prim'ərna	unkn	примерно
primərno	unkn	примерно
prišlos	unkn	Пришлось
prodaj	stem	продать
prodawets	unkn	продавец
prodawtsom	unkn	продавцом
produkta	unkn	продукт
produkti	unkn	продукт
produktə	unkn	продукт
prodykty	unkn	продукт
profesor	unkn	профессор
prokop	stem	Прокоп
prokopjewič	stem	Прокопьевич
promhos	unkn	промхоз
promisla	unkn	промысла
prosta	unkn	просто
prosto	unkn	просто
prowala	unkn	проваливаются.SLIP
prowaliwajutsa	unkn	проваливаются
prožil	unkn	прожил
prožila	unkn	прожила
prožili	unkn	прожили
prožitə	unkn	прожита
prədukt	unkn	продукт
prəduktə	unkn	продукты,продукт
prəmhos	unkn	промхоз
prəšol	unkn	пришел
prәmhos	unkn	промхоз
pr’iedit	unkn	приедет
pulki	stem	пуля
pura	stem	идти.по.следу
pura	unkn	идти.по.следу,бежать.по.следу
purta	stem	нож
purta	unkn	нож
puruh	unkn	порох
purul	stem	проткнуть
puruli	stem	проткнуть
puskaj	unkn	пускай
pusti	unkn	отпустить,пустить
pustoj	stem	пустой
pustɨ	stem	отпустить
putin	unkn	Путин
putə	unkn	лечить
pušnik	unkn	приемщик.пушнины
pušnina	unkn	пушнина
pušnom'ehowoj	unkn	пушно.меховой
pušnovo	unkn	пушного
pērēm	unkn	настоящий
pǝktiro	unkn	выстрелить
pǝktiron	unkn	выстрел
pǝtom	unkn	потом
pə	unkn	SLIP,INTJ?,по
pədumala	unkn	подумала
pəhit	unkn	расколоть
pəhiśi	unkn	расколоть
pəka	unkn	пока
pəktiron	unkn	выстрелить
pəktirōn	unkn	стрелять
pəktirōni	unkn	стрелять
pəktiru	stem	выстрелить
pəktiru	unkn	стрелять,выстрелить
pəktirō	unkn	выстрелить.из.ружья
pəktirū	unkn	стрелять,выстрелить
pəktirə	unkn	выстрелить
pəktirən	unkn	выстрелить
pəktirəni	stem	выстрелить.из.ружья
pəktirənə	stem	выстрелить.из.ружья
pəktirə̄	unkn	стрелять,выстрелить
pəktirə̄n	stem	выстрелить
pəktirə̄n	unkn	выстрелить
pəktirə̄ni	unkn	выстрелить
pəktirə̄wun	stem	ружье
pəktəroni	unkn	выстрелить
pəktərū	stem	выстрелить
pəktɨrō	stem	выстрелить.из.ружья
pəktɨrōmə	unkn	выстрелить.из.ружья.SLIP
pəktɨrə̄	stem	выстрелить.из.ружья,выстрелить
pəktɨrə̄n	stem	выстрелить.из.ружья,выстрелить
pəktɨrə̄nə	stem	выстрелить
pəməgal’i	unkn	помогали
pərikas	unkn	приказ
pərniškə	unkn	парнишка
pəruski	unkn	по.русски
pərəpal	unkn	переполошиться
pəstavit’	unkn	поставить
pətom	unkn	потом
pətpisat’	unkn	подписать
pətōm	unkn	потом
pətəmu	unkn	потому
pəši	stem	разорвать
pəťorkə	unkn	пятерка
pәktirōn	unkn	выстрелить
pәktәrә	unkn	выстрелить
pәnsianәr	unkn	пенсионер
pәnsii	unkn	пенсии
pәtkәt	unkn	бах.бах
pәtom	unkn	потом
pәńsija	unkn	пенсия
pәńśija	unkn	пенсия
p’r’ijedəš	unkn	приедешь
p’әďis’at	unkn	пятьдесят
r'ib'onka	unkn	ребенка
r'ižim	unkn	режим
r	unkn	раз.SLIP
rabo	unkn	slip
rabotali	unkn	работали
rabotat'	unkn	работать
rabotəl	unkn	работал
rabotət	unkn	работать
rad'it'il'ij	unkn	родителей
radiokomitət	unkn	радиокомитет
radistka	unkn	радистка
radujuś	unkn	радуюсь
rah	unkn	раз
rajon	unkn	район
rajoni	unkn	район
ran'šə	unkn	раньше
ras	unkn	раз
rasamaha	unkn	росомаха
raskazala	unkn	рассказала
raskazivali	unkn	рассказывали
raskazutə	unkn	расскажу.то
raskazywaju	unkn	рассказываю
raskažu	unkn	расскажу
raspals'a	unkn	распался
rasskazať	unkn	рассказать
rast'ir'alśa	unkn	растерялся
rast'ər'alśa	unkn	растерялся
rastajanijə	unkn	расстояние
ratsija	unkn	рация
ravno	unkn	равно
rawno	unkn	равно
raz	unkn	раз
razgavarivaju	unkn	разговариваю
razm	unkn	SLIP
razwərnul	unkn	развернул
rańit'	unkn	ранить
rańš'ə	unkn	раньше
raśt'ir'alśa	unkn	растерялся
ražd'ən'ija	unkn	рождения
rānenyj	unkn	раненый
rāni	unkn	ранить
rebitišək	unkn	ребятишек
rengen	stem	рентген
respublikanskaj	unkn	республиканский
rewol'utśija	unkn	революция
rečka	unkn	речка
rečki	unkn	речке
ribak	unkn	рыбак
ribaki	unkn	рыбак
ribačit	unkn	рыбачить
riga	unkn	Рига
ritatuktɨw	unkn	???
rodtsvəniki	unkn	родственники
rosomaha	unkn	росомаха
rot	unkn	род
rovdužnijə	RUS	ровдужные
rowno	unkn	ровно
roza	unkn	Роза
rubili	unkn	рубили
rukavitsɨ	RUS	рукавицы
rukəpašnuju	unkn	рукопашную
ružjom	unkn	ружьем
ružžu	unkn	SLIP
rybak	unkn	рыбак
rybačit’tə	unkn	рыбачить.то
rybačəli…	unkn	рыбачили…
rybzəvod	unkn	рыбзавод
rybəzavot	unkn	рыбозавод
rə	unkn	SLIP
rəb'atiškitə	unkn	ребятишки.то
rəboty	unkn	работы
rəkowad’aśih	unkn	руководящих
rənata	unkn	Рената
rəsamahu	unkn	росомаху
rəsamahə	unkn	росомаха
rəsbi	unkn	slip
rəsbiga	unkn	slip
rəsb’igajəcə	unkn	разбегаются
rəsskəžu	unkn	расскажу
rəzgar	unkn	разгар
rɨ	unkn	рыба.SLIP
r’ejsə	unkn	рейс
r’eskə	unkn	резко
r’etkə	unkn	редко
r’ečkə	unkn	речка
r’ib’ət’iškə	unkn	ребятишки
r’imontə	unkn	ремонт,ремонта
s'em'd’is'at	unkn	семьдесят
s'erg'ejif	unkn	Сергеев
s'ib'ə	unkn	себе
s'id'ət'	unkn	сидеть
s'im'əj	unkn	семей
s'imja	unkn	семья
s'in't'abr'	unkn	сентябрь
s'ipka	unkn	соболь
s'ipkan	unkn	соболь
s'irinda	unkn	Чиринда
s'istra	unkn	сестра
s'ičas	unkn	сейчас
s'ostri	unkn	сестры
s	unkn	SLIP,с
s...	unkn	с...
sa	stem	знать
sa	unkn	садик.SLIP,детский.сад.SLIP,знать,со
saboj	unkn	собой
sabralis	unkn	собрались
sad'ik	unkn	детский.сад
sadik	unkn	садик,детский.сад
saf	unkn	SLIP
safhos	unkn	совхоз
safhozof	unkn	совхозов
safs'əm	unkn	совсем
safśəm	unkn	совсем
sagdi	unkn	старый
sahar	stem	сахар
sahar	unkn	сахар
saji	unkn	чай
saldaty	unkn	солдаты
salo	unkn	сало
sam'i	unkn	сами
samajə	unkn	самое
sami	unkn	сами
samih	unkn	самых
samij	unkn	самый
samoje	unkn	самое
samol'ot	unkn	Самолет
samoloti	unkn	самолет
samolōt	unkn	самолет
saməj	unkn	самый
sar	unkn	Сарсикан.SLIP
sarśi	unkn	Сарсикан.SLIP
sarśikan	stem	Сарсикан
sarśikān	unkn	Сарсикан.VOC
saski	unkn	дальше
sat	stem	чай
savetskij	unkn	советский
sawhos	unkn	совхоз
sawoda	unkn	вещь
sawuri	unkn	взять
sawōda	unkn	вещи,вещь
sazr'el'i	unkn	созрели
saďik	unkn	садик
saŋār	stem	дыра
saška	unkn	Сашка
sā	unkn	знать
sda	unkn	сдавать.SLIP
sdavati	unkn	сдавать
sdawāsi	unkn	сдавать
se	unkn	ухо,SLIP
sel’host’ehńikum	unkn	сельхозтехникум
sel’skij	unkn	сельский
serg'ejew	unkn	Сергеев
sewer	unkn	север
shvat'ilśa	unkn	схватился
shvatka	unkn	схватка
si	unkn	2SG
sid'mom	unkn	седьмом
siksiŋa	unkn	брусника
sil'n'ij	unkn	сильных
silhozuprawl’ənijə	unkn	сельхозуправление
simi	unkn	боковая.плашка.в.лодке
simja	unkn	семья
simūrga	unkn	смолкнуть
sin	unkn	2SG
sint'abr'	unkn	сентябрь
sint’abr’	unkn	сентябрь
sinťabr	unkn	сентябрь
sinə	unkn	2SG.ACC
sipka	unkn	соболь
sir	unkn	доить
sittsa	unkn	ситца,
siďmom	unkn	седьмом
siŋilgən	unkn	снег
sī	unkn	2SG
skazat'	unkn	сказать
skazat'to	unkn	сказать.то
skazat	unkn	сказать
skazattə	unkn	сказать.то
skol'ko	unkn	сколько
skolskij	unkn	скользкий
skol’kə	unkn	сколько
skoro	unkn	скоро
skorə	unkn	скоро
skənčaicə	unkn	скончается
slafkǝ	unkn	Славка
slawy	unkn	славы
slu[čajə]	unkn	слу[чае]
služ	unkn	slip
služi	unkn	служить
sm'iləjə	unkn	смелее
smatr'a	unkn	смотря
smatr'u	unkn	смотрю
smutnə	unkn	смутно
snačala	unkn	сначала
snowa	unkn	снова
so	unkn	сильный(о.проявлении.качества)
sobira	unkn	собирать
sobol'	unkn	соболь
sogdonno	stem	спина
sok	stem	убить
sokori	unkn	потерять
soldat	unkn	солдат
soldati	unkn	солдат
soloki	stem	против.течения
soloki	unkn	против.течения
soloγū	stem	верхний.по.течению
solī	stem	верховье.реки
solīlō	stem	в.верхнем.течении
solōki	unkn	вверх.по.течению
somol'oti	unkn	самолет
sorok	unkn	сорок
sorəktr’et’əm	unkn	сорок.третьем
sos	unkn	SLIP
sovətskojə	unkn	Советское
sow'ət	unkn	совет
sowhozi	unkn	совхоз
soči	unkn	Сочи
soŋo	unkn	плакать
sp'ina	unkn	спина
spakojnyji	unkn	спокойный
spasibo	unkn	спасибо
sperwa	unkn	сперва
spetsialnije	unkn	специальные
spetspereselentsi	unkn	спецпереселенцы
spetsškola	unkn	спецшкола
spetzpereselntsef	unkn	спецпереселенцев
spička	unkn	спичка
spərvatə	unkn	сперва.то
spətsal'na	unkn	специально
sr'əďńuju	unkn	среднюю
srazu	unkn	сразу
sta	unkn	SLIP
stado	stem	стадо
stado	unkn	стадо
stadə	unkn	стадо
staim	unkn	стоим
stajanki	unkn	стоянки
stal	unkn	стал
stali	unkn	стали
stalin	unkn	Сталин
stalə	unkn	стало
stantsija	unkn	станция
staraja	unkn	старый
staran	unkn	стороны.SLIP
starani	unkn	стороны
starikami	unkn	стариками
starosti	unkn	старости
starših	unkn	старших
staršij	unkn	старший
starəńkij	unkn	старенький
stādo	unkn	стадо
stādə	unkn	стадо
step'eńi	unkn	степени
sto	unkn	что,чтобы.SLIP,сто
str'elka	unkn	Стрелка
strahu	unkn	страху
straš	unkn	страшный.SLIP
strelka	stem	Стрелка(поселок)
strogasti	unkn	строгости
strogij	unkn	строгий
stroil'i	unkn	строили
stroil	unkn	строил
stroili	unkn	строили
strojim	unkn	строим
stādə	unkn	стадо
stəiš	unkn	стоишь
stəpanič	unkn	Степанович
sudə	unkn	ссуда
suglan	unkn	суглан
suhī	stem	шуметь
sukə	unkn	трава
sulakī	unkn	лисица
sumk'i	unkn	сумки
sumka	unkn	сумка
sun	stem	2PL
sun	unkn	2PL
suru	stem	пойти
suru	unkn	уйти,пойти.SLIP,пойти
sušit’	unkn	сушить
svajəvo	unkn	своего
sveroferma	unkn	звероферма
svjazanyə	unkn	связанные
svoj	unkn	свой
sw'erhu	unkn	сверху
swajo	unkn	свое
swarśik	unkn	сварщик
swaďba	unkn	играть.свадьбу,свадьба,женить[?]
swe	unkn	SLIP
sā	stem	знать
sā	unkn	знать
sāgida	unkn	место.дальше
sāskī	unkn	дальше
sātira	stem	песец
sātira	unkn	песец
sātirə	stem	песец
sātirə	unkn	песец
sčitajut	unkn	считают
sō	stem	очень
sō	unkn	сильный(о.проявлении.признака),сильный(о.проявлении.качества),очень
sōli	unkn	язык
sōlī	unkn	slip,солить
sōm	stem	закрыть
sšiti	unkn	сшиты
sūko	unkn	топор
sūləmə	stem	румяный
sǝ	unkn	SLIP
sə	unkn	со
səfhos	unkn	совхоз
səkon	unkn	закон
səktə	unkn	подстилка,ветка
səldatə	unkn	солдаты
səlo	unkn	село
sələ	stem	железо
səmnatsatij	unkn	семнадцатый
səpožnikəf	unkn	Сапожников
sərī	unkn	проснуться
sərkəw	unkn	церковь
səstə	unkn	???
səŋty	unkn	порвать
səžival	unkn	сжевал
s’evər	unkn	север
s’imja	unkn	семья
s’ipkan	unkn	соболь
s’irinda	unkn	Чиринда
s’uda	unkn	сюда
s’uka	unkn	трава
s’ūkə	unkn	трава
t'ip'er	unkn	теперь
ta	stem	тот
ta	unkn	SLIP,тот,потом.SLIP,также.SLIP,тогда.SLIP,то
ta=	unkn	SLIP
tab	unkn	собирать
tadu	stem	там
tadu	unkn	там
taduk	stem	потом
taduk	unkn	потом,оттуда
tadukə	unkn	потом
tadū	unkn	тогда,там
tadū	stem	там
tadū	unkn	там
tadūk	unkn	потом
tagda	unkn	тогда
tahi	unkn	гнать
tahī	unkn	гнать
taiga	unkn	тайга
taigu	unkn	тайгу
tajg'ə	unkn	тайге
tajga	unkn	тайга
tajgam	unkn	тайгам
tajmeń	unkn	Таймень
tajmir	unkn	Таймыр
tajmura	stem	Таймура
tajmura	unkn	Таймура
tajožnijə	unkn	таежные
tak'iji	unkn	такие
tak	unkn	так,по
takije	unkn	такие
takiji	unkn	такие
takim	unkn	таким
takoj	unkn	такой
takojə	unkn	такое
takto	unkn	так.то
taku	unkn	собрать
takžə	unkn	также
tala	stem	туда
tala	unkn	тогда,там,туда
talaka	unkn	есть.сырым
talā	unkn	туда
tali	unkn	slip
talkan	unkn	мука
talu	stem	береста
talu	unkn	береста
talunduk	unkn	SLIP
talā	unkn	туда
talš'inoj	unkn	толщиной
talū	unkn	береста
tam	unkn	собрать,там,так
tama	unkn	платить
tan	stem	вытянуть
tan	unkn	курить,сосчитать
tani	stem	вытянуть
tani	unkn	читать,считать
tankovih	unkn	танковых
tanu	unkn	вытянуть.SLIP
tanči	stem	тянуть
tap	unkn	собрать
tapača	unkn	Тапачонок.SLIP
tapačāti	unkn	Тапачонок
taptyg'ina	unkn	топтыгина
taptyg’in	unkn	Топтыгин
tar	stem	тот
tar	unkn	тот,то,туда
tara	stem	тот.ACC
tara	unkn	тот,тот.ACC
tarba	unkn	столько
tardа̄r	unkn	?
tare	unkn	тот.ACC
targit	unkn	оттуда
targitə	unkn	оттуда
tari	stem	тот
tari	unkn	тот,тот.SLIP,этот
taril	unkn	SLIP
tarin	unkn	SLIP
tarit	unkn	поэтому,оттуда,оттого
tariŋi	unkn	тот.INDPS.SLIP
tariŋilnu	unkn	тот.INDPS.PL.COM.SLIP
tariŋiltikī	unkn	тот.INDPS.PL.ALL.SLIP
tarjaklā	stem	в.ту.сторону
tarjāka	unkn	та.сторона
tartiki	unkn	туда
tartə̄ki	unkn	туда
tarā	unkn	этот.ACC
tarə	stem	тот.ACC
tarə	unkn	тот,тот.ACC,то
tas'it	unkn	тащит
tas	unkn	SLIP,гнать
taskaem	unkn	таскаем
taskajem	unkn	таскаем
tatar	unkn	чесотка
tati	unkn	научиться,надеть.одеться,учиться
tatiha	unkn	SLIP
taty	unkn	научиться
tatɨkān	stem	привыкший
taw	stem	собрать
taw	unkn	собрать
tawalə̄	unkn	туда.недалеко
tawari	unkn	тот.RFL.PL.SLIP
tawit	stem	ковать
tawu	unkn	собрать,SLIP,плыть.на.плоту
tawut	unkn	поставить(капкан,ловушку)
tawə	unkn	собрать
taŋ	unkn	читать,считать
taŋu	unkn	счет,количество
taš'əm	unkn	тащим
tašim	unkn	тащим
tāduk	unkn	оттуда
tādū	unkn	там
taγa	stem	зацепиться
taγa	unkn	попасть(в.ловушку),зацепиться
taγi	unkn	узнать
taγī	unkn	гнать
tehnikum	unkn	техникум
telegramma	unkn	телеграмма
telegrammu	unkn	телеграмма
telogrejka	unkn	телогрейка
terapeft	unkn	терапевт
terapefťə	unkn	терапевт
teritorija	unkn	территория
ti(n)	unkn	освободить.от.упряжи
ti	unkn	отпустить.SLIP,отпустить,ты
tigdə	unkn	пойти(о.дожде),дождь
tigi	unkn	подстерегать
tigə	unkn	посуда
tiha	unkn	плавать
tihiśə	unkn	тысяча
tihə	unkn	тихо
tijəwun	unkn	посох
tik	unkn	упасть
tikin	unkn	теперь,сейчас
tikčaki	unkn	Тыкчаки
til	stem	понять
til	unkn	понять
tili	stem	понять
tili	unkn	понять
tili	понять.SLIP	понять.SLIP
tilpə	stem	спустить.западню
tim	unkn	SLIP
timaltanə	unkn	утром
timannə	unkn	утром
timatnə	unkn	утром
timi	unkn	попасть в цель
timī	unkn	попасть.в.цель.SLIP,попасть.в.цель
timāltāna	unkn	утром
timānə	unkn	утром
timātnə	unkn	утром
tin	unkn	отпустить
tini	unkn	отпустить
tipa	stem	замазать
tipa	unkn	типа
tiper’	unkn	теперь
tirga	unkn	настать(о.дне),днем
tirgaksa	unkn	пообедать
tirganī	unkn	день/время,день
tirə	unkn	задавить
tirə̄	unkn	давить,задавить
tičenijə	unkn	течение
tiĺga	unkn	днем
tiŋariŋə	unkn	в.прошлом.году
tiŋəptun	unkn	подпруга,связать.подпругой
tiśača	unkn	тысяча
tiśači	unkn	тысячи
tiγis'ə	unkn	тысяча
tiγiśa	unkn	тысяча
tiγīs’ə	unkn	тысяча
to	stem	то
to	unkn	тогда.SLIP,SLIP,то
togda	stem	тогда
togo	stem	огонь
togo	unkn	огонь
togot	stem	лежать(о.животном)
togoči	unkn	река.Тогочи
tojist'	unkn	то.есть
toka	unkn	только
tokto	stem	разрубить
tokto	unkn	разрубить,зарезать
tol'	unkn	только.SLIP
tol'ko	unkn	только
tolgoki	unkn	санки
tolgokī	unkn	санки
tolgokī	stem	санки
tolgokī	unkn	санки,санка,сани
tolgəki	unkn	санки
toli	unkn	тогда
tolik	unkn	Толик
tolkiśi	stem	видеть.сон
tolko	unkn	только
tolstoj	unkn	толстой
tol’kə	unkn	только
tonk'ijə	unkn	тонкие
tonkiji	unkn	тонкие
torgā	unkn	ткань
toro	unkn	устоять
torča	unkn	торчало.SLIP
torō	stem	справиться
tow	unkn	собрать
towu	unkn	поставить[ловушку]
towuli	unkn	кольцо
toze	unkn	тоже
tozowka	unkn	тозовка
tozəfka	unkn	тозовка
toďo	stem	поверить
toďodō	unkn	поверить.SLIP
tońa	unkn	Тоня
tońi	unkn	???
tože	unkn	тоже
tožǝ	unkn	тоже
tožə	stem	тоже
tožə	unkn	тоже
tožә	unkn	тоже
tōli	unkn	тогда
tōlī	unkn	тогда
toγo	stem	огонь
toγo	unkn	лежать.SLIP,сесть,лежать
toγot	unkn	сидеть
tr'i	unkn	три
trawatə	unkn	трава.то
trenin	unkn	Тренин
treťjej	unkn	третьей
tri	unkn	тридцатого.SLIP,три
tritsatom	unkn	тридцатом
tritsatovo	unkn	тридцатого
tro=	unkn	трогать.SLIP
trofim	unkn	Трофим
trofimi	unkn	Трофим
trofimowna	unkn	Трофимовна
trogaj	stem	трогать
truda	unkn	труда
trudadńi	unkn	трудодни
trudowoj	unkn	трудовой
trəfim	unkn	Трофим
tselyj	unkn	целый
tsentra	unkn	центр
tswet	unkn	цвет
tsəlyj	unkn	целый
tu(γ)	unkn	так
tu	unkn	зимой.SLIP,SLIP,так,пятьдесят.SLIP,пять.SLIP
tuda	unkn	туда
tug	stem	так
tug	unkn	так
tuga	unkn	настать(о.зиме),зимой
tugadu	unkn	SLIP
tugi	unkn	так
tugə	unkn	туго,зимой,зимовать,настать(о.зиме)
tugε	unkn	так
tuju	stem	угощать
tujə	unkn	так
tuk	stem	так
tuk	unkn	так,залезть.SLIP
tukalan	unkn	Тукалан
tukalo	stem	земля[субстанция]
tuksa	stem	убежать
tuksa	unkn	побежать,бежать.галопом,побежать.SLIP,убежать,бежать,бегать
tuksan	stem	убежать
tuksan	unkn	убежать
tuksā	stem	убежать
tuksā	unkn	убежать
tuksāni	stem	убежать
tuksə	unkn	бегать
tukti	stem	залезть
tukti	unkn	залезть
tuktɨ	stem	залезть
tukša	unkn	убежать
tukšā	stem	убежать
tul	unkn	SLIP
tulila	unkn	на.улице
tulilō	unkn	на.улице
tulilə̄	stem	на.улице
tulilə̄	unkn	на.улице
tuliski	stem	на.улицу
tuliskī	stem	на.улицу
tuliskī	unkn	на.улицу
tuliγida	unkn	место.снаружи
tuliγidā	unkn	место.снаружи
tulo	unkn	поставить(ловушку)
tulu	unkn	зимой.SLIP
tulī	stem	место.снаружи
tulīlō	stem	на.улице
tulīlō	unkn	на.улице
tulīlə̄	stem	на.улице
tulə	stem	поставить(капкан,ловушку)
tulə	unkn	поставить(капкан,ловушку),ставить,ставить(сеть,капкан),поставить(ловушку)
tulə̄	stem	поставить(капкан,ловушку)
tulə̄	unkn	ставить(сеть,капкан)
tumńi	stem	плюнуть
tumńi	unkn	плюнуть
tun	unkn	пять.SLIP
tundru	unkn	тундру
tundry	unkn	тундры
tundrə	unkn	тундра
tundəra	unkn	тундра
tunguska	unkn	Тунгуска
tungusku	unkn	Тунгуску
tunguskǝ	unkn	Тунгуске
tuni	SLIP	SLIP
tunŋa	stem	пять
tunŋa	unkn	пять.SLIP,пять
tunŋa=	unkn	пять.SLIP
tunŋad’ar	unkn	пятьдесят
tunŋaďa	unkn	пятьдесят
tunŋaďar	unkn	пятьдесят
tur	unkn	SLIP
tura	unkn	разговаривать,Тура
turga	stem	наткнуться
turot	unkn	разговаривать
turpāka	unkn	Школьный.мыс
turskaja	unkn	Турская
turu	unkn	Тура.SLIP,Тура
turuhanska	unkn	Туруханск
turuhanskə	unkn	Туруханск,Туруханске
turuko	unkn	соль
turum	unkn	засолить,солить,задержать.SLIP
turunmu	stem	задержать
turāmi	unkn	Турами
turō	unkn	разговаривать
turōn	unkn	разговаривать
turə	unkn	туре
turə̄	SLIP	разговаривать.SLIP
turə̄	stem	разговаривать
turə̄	unkn	разговаривать
tut	unkn	тут
tutančani	unkn	Тутончаны
tuton	unkn	Тутончаны.SLIP
tutončana	unkn	Тутончаны
tutončani	unkn	Тутончаны
tutončanə	stem	Тутончаны
tutončanə	unkn	Тутончаны
tutu	SLIP	SLIP
tutu	stem	ползти
tuŋ	stem	так
tuŋ	unkn	SLIP,так
tuŋa	unkn	пять
tuŋad’ar	unkn	пятьдесят
tuŋaďan	unkn	пятьдесят
tuŋaďar	unkn	пятьдесят
tuŋańama	unkn	пятьсот
tuŋguskaj	unkn	Туңусский
tuŋi	unkn	пять
tuŋə	unkn	пять
tuŋər	unkn	мелководье
tušonka	unkn	тушенка
tuɣi	unkn	так
tuγ	stem	так
tuγ	unkn	так
tuγa	unkn	зимой.SLIP,настать(о.зиме),так,зимой
tuγar	unkn	вдоль
tuγi	stem	так
tuγi	unkn	так
tuγi[l?]	stem	так[PL? Неразборчиво]
tuγu	stem	идти.по.насту
tuγu	unkn	так,идти.по.насту
tuγə	stem	так,зимой,настать(о.зиме)
tuγə	unkn	так,зимой,настать(о.зиме).SLIP,зимовать,настать(о.зиме)
tuγənəs	unkn	настать(о.зиме).SLIP
tā	stem	тот
tā	unkn	тот
tāduk	unkn	потом,оттуда
tādū	unkn	тогда,там,туда
tādū]	unkn	там]
tādūk	unkn	потом
tāg	unkn	узнать
tāka	stem	бревно
tālā	unkn	туда
tālā	stem	туда
tālā	unkn	тогда,там,туда
tālī	unkn	там,туда
tālə̄	unkn	туда
tān	unkn	курить
tāni	unkn	курить
tētē	stem	Тетея
tī	unkn	отпустить
tīhis’ə	unkn	тысяча
tīkin	unkn	теперь,сейчас
tīmatnə	unkn	утром
tīn	unkn	отпустить,пустить
tīni	unkn	отпустить
tīrə	stem	задавить
tō	unkn	тогда.SLIP,тот
tōl	unkn	тогда.SLIP
tōli	stem	тогда
tōli	unkn	тогда
tōliŋə̄	unkn	тотчас
tōlī	stem	тогда
tōlī	unkn	тогда,SLIP
tūhsа	unkn	бежать
tūkti	unkn	подниматься
tūrū	unkn	Тура
tūrūm	unkn	засолить
tūγə	unkn	зимой
tɒlī	stem	тогда
tə	unkn	slip,то
təd'ə̄	unkn	верить,правда,убедиться
təf	stem	нагрузить
təg	unkn	SLIP
təgə	stem	сесть
təgə	unkn	сесть
təgəmi	stem	завтра
təgəminin	stem	завтра
təgəminin	unkn	завтра
təgəminun	stem	завтра
təgəmī	stem	завтра
təgəmī	unkn	завтра
təgəmīnin	stem	завтра
təgət	unkn	SLIP
təju	unkn	чистить
təkojə	unkn	такое
təlgə	unkn	разделывать
təli	stem	сухое.мясо,засушить.мясо
təlin	stem	сухое.мясо
tələ	stem	растянуть.шкуру
tən	unkn	SLIP,водораздел
təp	stem	нагрузить
təpkə	stem	крикнуть
təpkə	unkn	кричать,крикнуть
təput	unkn	забить
təpūt	unkn	забить
təpūči	unkn	забить
tər	unkn	этот,тот
tərganī	unkn	день
tərgəksə	stem	вещь
tərūt	unkn	назначить.место.и.время
tərəgō	stem	бить[скот]
tərəhə̄	unkn	колотить
tərə̄	unkn	справиться
təskali	unkn	таскали
təskat’	unkn	таскать
təskaťi	unkn	таскать
tət	stem	надеть
tət	unkn	надеть
təti	stem	одеться,надеть
təti	unkn	SLIP,одеться,надеть,научиться,одежда
tətigə̄	unkn	одежда
tətiγə	unkn	одежда
tətɨ	unkn	одеться,надеть
tətɨgə̄	stem	одежда
tətɨgə̄	unkn	одежда
tətɨγə̄	stem	одежда
təvarišči	unkn	товарищи
təw	stem	нагрузить
təw	unkn	поставить
təwlī	stem	собрать.ягоды
təwlō	stem	собрать.ягоды
təwlōhəś	unkn	пойти.собрать.ягоды.SLIP
təwlə̄	stem	собрать.ягоды
təwu	stem	патрон
təwū	unkn	нагрузить
təwə	unkn	поймать.на.лету,сесть
təďō	unkn	правда
təďə̄	stem	поверить
təə	unkn	сесть,сидеть
tə̄b	unkn	положить
tə̄duk	unkn	потом
tə̄li	unkn	тогда
tə̄lī	unkn	тогда
tə̄līnun	unkn	тотчас
tə̄lī	unkn	тогда
tə̄mu	unkn	плот
tə̄r	stem	тот
tə̄r	unkn	там.INTS,туда,тот.INTS
tə̄̄li	unkn	тогда
təγ	unkn	разгрузить[нет.в.словаре]
təγə	stem	сесть
təγə	unkn	прийти,сесть.SLIP,сесть,народ
təγəmī	unkn	завтра
təγəmīŋin	unkn	завтра
təγəw	unkn	сесть.SLIP
tɨgə	stem	посуда
tɨgə	unkn	посуда
tɨjəpkōn	stem	посох
tɨkin	stem	сейчас
tɨku	stem	рассердиться
tɨkul	unkn	рассердиться.SLIP
tɨkəɲī	stem	вчерашний
tɨl	stem	понять
tɨmār	stem	утро
tɨmātnə	stem	утром
tɨmī	stem	попасть.в.цель
tɨpa	stem	замазать
tɨpa	unkn	замазать.SLIP
tɨparā	stem	грязь
tɨr	unkn	SLIP
tɨrga	stem	настать(о.дне),днем
tɨrə	stem	задавить
tɨγə	stem	посуда
tәlki	unkn	хорошо.что
tәpәr'	unkn	теперь
tәro	unkn	справиться
tәrā	unkn	справиться
tә̄l’ī	unkn	тогда
t’ehńikum	unkn	техникум
t’ip’er’	unkn	теперь
u	SLIP	учить.SLIP
u	unkn	однажды.SLIP,скоблить,прежде.SLIP,у
ubdu	stem	влезть
ub’iga	unkn	slip
ub’iraj	unkn	убирать
ud'a	unkn	след
udaγan	stem	шаманка
udigir	unkn	Удыгир
udiγir	unkn	Удыгир
udobna	unkn	удобно
udurū	stem	клюв
ud’a	unkn	след
ug	stem	сесть.в.лодку
ug	unkn	SLIP,сесть.верхом
uga	unkn	нести
ugdu	stem	пролезать
ugla	unkn	обдирать.кору
ugnal’i	unkn	угнали
ugu	stem	берег
ugu	unkn	берег,сесть.верхом
ugī	unkn	место.сверху
ugīdō	unkn	место.сверху
ugīskī	stem	вверх
ugū	unkn	берег,тащить.на.себе
ugər	stem	поднять
uh'it	unkn	учиться
uhi	unkn	привязать
uhit	unkn	учиться
uho	unkn	заболеть,болеть
uhī	stem	веревка
uhō	stem	болеть
uhōďə	SLIP	болеть.IPFV.SLIP
uj	stem	привязать
uj	unkn	привязать
uji	stem	привязать
uji	unkn	привязать
uju	stem	привязать
uju	unkn	привязать
ujuməl	unkn	???
ujus’ə	unkn	ездить.верхом
ujū	unkn	привязать
ujə	stem	давнее.время
ujə	unkn	возраст/давнее.время,давнее.время
uk	unkn	сесть.верхом
uksə	stem	рукав
uku	unkn	пелядь,сосать
ukunmi	unkn	молоко
ukunmī	stem	молоко
ukučōn	stem	сука
ul	stem	добраться
ulap	unkn	промокнуть
uldi	unkn	шить
uldī	stem	сшить
uldī	unkn	сшить,шить
uldə	stem	мясо
uldə	unkn	шить,мясо(падеж),мясо.SLIP,мясо
uldəl	SLIP	мясо.PL.SLIP
ulgu	unkn	рассказать.SLIP
ulgukī	unkn	бурундук
ulgur	stem	рассказ
ulgur	unkn	рассказать,рассказ
ulguri	stem	рассказ
ulgurə	unkn	рассказать
ulguson	unkn	рассказать
ulgusōn	unkn	рассказать
ulgučon	unkn	разговаривать
ulgučō	unkn	рассказывать,рассказать
ulgučōn	stem	рассказать
ulgučōn	unkn	рассказать
ulgučōni	unkn	рассказать
ulgučə	stem	рассказать
ulgučə	unkn	рассказать
ulgučəń	unkn	рассказать
ulgučə̄n	unkn	рассказать
ulgučə̄ni	unkn	рассказать,рассказывать
ulguśoni	unkn	рассказывать
ulguśōn	stem	рассказать
ulguśōn	unkn	рассказать
ulgən	unkn	нанизать
uli	unkn	грести.веслами,кормить
ulik	unkn	белка.SLIP
ulin	stem	грести.веслами
ulitsə	unkn	улице
ulī	unkn	кормить
ullī	stem	сшить
ullə	stem	мясо
ullə	unkn	мясо
ulləl	unkn	мясо.SLIP
ulo	unkn	SLIP
ulokit	unkn	обмануть
ulō	unkn	варить
ulōkki	unkn	обмануть
ulrə	unkn	мясо
ulta	unkn	отозваться(об.эхе)
ulu(kī)	unkn	белка
ulu	stem	белка
ulu	unkn	белка.SLIP,белка
ulu[ki]	unkn	белка
ulu[оговорка.вместо.ulə?]	stem	выкопать
uluki	unkn	белка
uluku	unkn	белка.SLIP
ulukurə	unkn	белка.SLIP
ulukī	stem	белка
ulukī	unkn	белка.SLIP,белка
ulumi	unkn	белковать
ulumiŋnərəw	unkn	белковать.SLIP
ulumu	unkn	белка.SLIP
ulumī	unkn	охотиться.на.белку
ulī	stem	накормить
ulī	unkn	кормить,накормить
ulōki	unkn	обман
ulōkin	stem	обманщик
ulōkit	stem	обманывать
ulōkki	stem	обманывать
ulōkki	unkn	обманывать
ulə	stem	выкопать
ulə	unkn	сварить,выкопать
ulə̄	stem	сварить
ulə̄kit	unkn	обманывать
ul’i	unkn	кормить
um'irl'i	unkn	умерли
um'əl'i	unkn	умели
um	unkn	пить,SLIP,послать
uma	unkn	костный.мозг
umerla	unkn	умерла
umi	unkn	пить
umir	unkn	умер
umkān	stem	ложка
umno	stem	один.раз
umno	unkn	один.раз
umnō	stem	один.раз
umnō	unkn	однажды,один.раз
umnə	stem	один.раз
umnə	unkn	один.раз
umnəj	unkn	умный
umnə̄	stem	один.раз
umnə̄	unkn	один.раз
umu	unkn	SLIP,один
umuk	stem	один
umuki	stem	один(о.человеке)
umuki	unkn	один(о.человеке)
umukin	stem	один(о.человеке)
umukin	unkn	один(о.людях),один(о.человеке),один[о.человеке]
umukkōn	unkn	один.раз
umukkō	stem	один
umuko	unkn	один
umukon	unkn	один
umukō	unkn	один
umukōn	unkn	один
umukō	stem	один
umukōn	stem	один
umukōn	unkn	один
umukən	unkn	один
umukə̄n	stem	один
umukə̄n	unkn	один
umun	stem	один
umun	unkn	один
umunuktə	unkn	вместе
umūkin	unkn	один(ALONE)
umūkōn	unkn	один
umūkə̄n	unkn	один
umān	unkn	костный.мозг
umūkōn	unkn	один
umūkə̄n	unkn	один
umūntəgin	unkn	одинаковый
umūnup	stem	соединиться
umūnup	unkn	соединиться
umət	unkn	вдруг
uni	SLIP	SLIP
uniə	unkn	продать
unta	unkn	обувь
unə	stem	рано
unə	unkn	рано.утром
un’i	unkn	продать
up	unkn	SLIP
upal	unkn	упал
upka	unkn	весь
upkat	stem	весь
upkat	unkn	весь
upkači	stem	весь
upkači	unkn	весь
upro	unkn	SLIP
ura	stem	промахнуться
urgə	unkn	тяжесть
urgəktə	unkn	овод
urgəpču	unkn	тяжелый
uri	stem	вытащить
uri	unkn	вытаскивать
urikīt	stem	стойбище
urilə̄n	unkn	стойбище
urin	unkn	остановиться.на.одновневную.стоянку
urinə	stem	остановиться.на.однодневную.стоянку
urinə	unkn	остановиться.на.однодневную.стоянку
urko	unkn	дверь
urku	stem	мешать
urkə	stem	дверь
urkə	unkn	дверь
uru	stem	обрадоваться
uru	unkn	промахнуться???,радоваться,собрать.SLIP
urun	stem	обрадоваться
urun	unkn	обрадоваться
urup	unkn	собрать
uruwu	unkn	собрать
uručno	unkn	SLIP
urā	unkn	промахнуться
urī	stem	вытащить
urīhi	unkn	выкопать
urīhin	unkn	выкопать
urīnə	unkn	остановиться.на.однодневную.стоянку
urūnčə	stem	обрадоваться
urūpču	unkn	плохой
urə	stem	лес,гора
urə	unkn	SLIP,гора
urəgə̄n	unkn	обрыв
urə̄	unkn	гора
urəγə̄n	unkn	горный.хребет
us'is'i	unkn	учиться.SLIP,учиться
us	unkn	срезать
usilə	unkn	привязать
usisi	unkn	учиться
usit	unkn	учиться
usī	unkn	узда,завязка
usmatr'əniju	unkn	усмотрению
uspet	unkn	успеть???,успеть
uspivat	unkn	успевать
uspət	unkn	успеть
usta	unkn	весь
ustə	unkn	весь,весь{*},весь.SLIP
ustən	unkn	весь
usə	unkn	оружие
us’it	unkn	учиться
us’oba	unkn	учеба
utokogir	unkn	Утукогир
utrəm	unkn	утром
utālə	stem	раньше
utōlə	stem	раньше
utōlə	unkn	раньше,прежде
utōlә	unkn	прежде
utələ	unkn	прежде
utəp’il’i	unkn	утопили
utə̄ləpti	stem	раньше
utə̄lə̄	unkn	прежде
uv'izut	unkn	увезут
uvačan	unkn	Увачан
uw'idala	unkn	увидала
uwažaśi	unkn	уважать
uč	unkn	SLIP
učaga	unkn	учага
učage	unkn	учаге
učalā	unkn	везти.верхом
učami	unkn	Учами
učastka	unkn	участка
učastok	unkn	участок
učen'iki	unkn	ученик
učeniki	unkn	ученик
uči	unkn	учиться
učilsai	unkn	учиться
učils’ə	unkn	учился
učilśa	unkn	учился
učilša	unkn	учиться
učisi	unkn	учиться
učit'el'n'i	unkn	учительница.SLIP
učit'el'n'itsa	unkn	учительница
učit	unkn	учить,учиться
učitelnitsa	unkn	учительница
učit’əl’nic	unkn	учительница
učiśi	unkn	учиться
učiťel	unkn	учитель
učāmi	unkn	Учами
učīt	unkn	учиться
uďa	stem	след,дорога
uďa	unkn	след,дорога
uďaśin	stem	броситься.по.следу
uńaptu	SLIP	шило.SLIP
uńaptu	stem	шило
uńiē	stem	продать
uńo	unkn	завернуть
uńos	unkn	SLIP
uŋ	stem	этот
uŋ	unkn	отправить,бубен.SLIP,послать
uŋi	unkn	отправить
uŋkakta	unkn	снег.на.ветках
uŋkon	unkn	чашка.для.клея
uŋktuwun	unkn	бубен
uŋktəwən	unkn	бубен
uŋku	stem	насыпать
uŋku	unkn	насыпать
uŋkulbu	stem	выливаться
uŋtu	unkn	SLIP,бубен.SLIP
uŋtuwu	unkn	бубен
uŋtuwun	stem	бубен
uŋtuwun	unkn	бубен
uŋtuwuni	stem	бубен
uŋtuwə	unkn	бубен
uŋun	stem	этот
uŋun	unkn	этот
uśami	unkn	Учами
uśis’	unkn	SLIP
uśit	stem	учиться
uśit	unkn	учить,учиться
uśiśi	unkn	учить,учиться
uśiśil'	unkn	учитель
uš	unkn	уж
uši	unkn	узда.SLIP,узда
ušli	unkn	ушли
uš’ami	unkn	Учами
uťastok	unkn	участок
už	unkn	уж
uže	stem	уже
uže	unkn	уже
užə	stem	уже
užə	unkn	уже,там,так
ūďa	unkn	след
uγa	stem	нести
uγa	unkn	нести
uγiduk	stem	сверху
uγidō	unkn	высота
uγilī	stem	поверху
uγiski	unkn	наверх
uγiskī	stem	наверх
uγorobi	unkn	угробить
uγot	unkn	вот
uγu	unkn	берег
uγusaki	unkn	верховой.олень
uγučak	stem	верховой.олень
uγučak	unkn	верховой.олень.SLIP
uγī	stem	веревка
uγīlō	stem	наверху
uγīr	stem	поднять
v'idat'	unkn	видать
v'iz	unkn	везде.SLIP
v'izd'ə	unkn	везде
v'izl'i	unkn	везли
v'izla	unkn	везла
v'os	unkn	вез
v'ət'ərantruda	unkn	ветеран.труда
v	unkn	в
va	unkn	во
vaabšə	unkn	вообще
vaapš'ə	unkn	вообще
vajna	unkn	война
valenťinovič	unkn	Валентинович
valera	unkn	Валера
valintin	unkn	Валентин
varənjə	unkn	варенье
vas'a	unkn	Вася
vas'ka	unkn	Васька
vasiljəvič	unkn	Васильевич
vasiljəvna	unkn	Васильевна
vaspitatil'əm	unkn	воспитателем
vaz'il'i	unkn	возили
vaz'ili	unkn	возили
vaśmom	unkn	восьмом
vedәmәsti	unkn	ведомости
vek	unkn	век
verto	unkn	SLIP
vertoloti	unkn	вертолет
vetih	unkn	в.этих
vib'ivali	unkn	выбивалы
vid'əli	unkn	видели
vipalńat	unkn	выполнять
virastut	unkn	вырастут
virtal'ot'i	unkn	вертолете
virtal'ot	unkn	вертолет
virtal'ota	unkn	вертолета
virtal’ot	unkn	вертолет
virtol'oti	unkn	вертолет
virtolot	unkn	вертолет
virtol’oti	unkn	вертолет
virtəl’oty	unkn	вертолеты
visnoj	unkn	весной
vit	unkn	slip
vjuk'i	unkn	вьюки
vladimirovič	unkn	Владимирович
vlast'	unkn	власть
vmesto	unkn	вместо
vnis	unkn	вниз
vnučatɨ	unkn	внучата
vo	unkn	во
vobšǝm	unkn	в.общем
vobšəm	unkn	в.общем
vojsk	unkn	войск
von	unkn	вон
vot	unkn	вот
vr'əm'a	unkn	время
vr'əm'ən'i	unkn	времени
vrema	RUS	время
vrema	unkn	время
vremja	unkn	время
vrəm'a	unkn	время
vs'akom	unkn	всяком
vstr'ičal	unkn	встречал
vs’otəki	unkn	всё.таки
vtəroj	unkn	второй
vy	unkn	вы
vydel’ali	unkn	выделяли
vyrəsli	unkn	выросли
vyučitsə	unkn	выучиться
vyšli	unkn	вышли
vyžəli	unkn	выжили
vərhnəymbaskə	unkn	Верхнеимбатск
vəri	unkn	варить.SLIP
vərnulis	unkn	вернулись
vərtal'ot	unkn	вертолет
vərtol'ot	unkn	вертолет
vət	unkn	вот
vәračom	unkn	врачом
vәtәran	unkn	ветеран
v’ek	unkn	век
v’ečǝrǝm	unkn	вечером
v’irtəl’ot	unkn	вертолет
v’r’em’ə	unkn	время
w'ezd'ē	unkn	везде
w'əsna	unkn	весна
w	unkn	в
wa	stem	убить
wa	unkn	SLIP,убить,Сатана.SLIP
wajə	unkn	главный.рог
wakunajka	unkn	река.Вакунайка
walentina	unkn	Валентина
waločitsa	unkn	волочится
wam	unkn	вам
warak	stem	Сатана
warwara	unkn	Варвара
wasilewna	unkn	Васильевна
wasilij	unkn	Василий
wastok	unkn	восток
waśa	unkn	Вася
waśilij	stem	Василий
waśilij	unkn	Василий
wā	unkn	убить
wdruk	unkn	вдруг
wek	stem	все.время
wek	unkn	век,все.время
wertaloti	unkn	вертолет
wertolot	unkn	вертолет
wertolōt	unkn	вертолет
wertolōti	unkn	вертолет
wes	stem	весь
wes	unkn	все
wesi	unkn	весь
weś	unkn	весь
weśə	stem	весь
wēk	unkn	всегда,все.время
wēs	unkn	весь
wibari	unkn	выборы
wibori	unkn	выборы
wiktorija	unkn	Виктория
wiktorəwna	unkn	Викторовна
wilnis	unkn	Вильнис
wilū	unkn	Вилюй
wirtoľot	unkn	вертолет
wirtoľoti	unkn	вертолет
wiwi	unkn	Виви
wizďə	unkn	везде
wiďel	unkn	видел
wladimir	unkn	Владимир
wnuki	stem	внук
wnuki	unkn	внук
wnučka	stem	внучка
wnučka	unkn	внучка
wojennij	unkn	военный
wojna	stem	война
wojna	unkn	война
wolka	unkn	волка
won	unkn	вон
wosp'itatel'	unkn	воспитатель
wospitaťeli	unkn	воспитатель
wot	stem	вот
wot	unkn	вот
woti	unkn	изгородь(?)
wowka	unkn	Вовка
wōta	unkn	изгородь
wragi	unkn	враги
wrak	unkn	враг
wras	unkn	враз
wrač	unkn	врач
wrаč	unkn	врач
wseh	unkn	всех
wspomogatelnaj	unkn	вспомогательный
wstreťil	unkn	встретил
wtoroj	unkn	второй
wupor	unkn	в.упор
wuse	unkn	уже
wwerh	unkn	вверх
wā	stem	убить,убить.SLIP
wā	unkn	добыть,убить,убивать,убить.SLIP,ловить
wēwa	stem	сойти.с.ума
wəjna	unkn	война
wək	unkn	все.время
wəki	unkn	все.время
wərtoloti	unkn	вертолет
wət	unkn	вот
wɨrawniwajut	unkn	выравнивают
xoroso	unkn	хорошо
z'eml'e	unkn	земле
z'imoj	unkn	зимой
z'imowjo	unkn	зимовье
z'ďəś	unkn	здесь
z	unkn	с
za	unkn	за,SLIP,занимались.SLIP
zaat'ehń’ik	unkn	зоотехник
zaatehnik	unkn	зоотехник
zaatehńik	unkn	зоотехник
zabil	unkn	забыл
zabila	unkn	забыла
zabɨla	unkn	забыла
zabәl’elә	unkn	заболела
zaja	unkn	заявке.SLIP
zajafk'ə	unkn	заявке
zajafka	unkn	заявка,заявке
zakazival'i	unkn	заказывали
zakidyvajuttə	unkn	закидывают.то
zako	unkn	закопать.SLIP
zakopat’	unkn	закопать
zamuz	unkn	замуж
zan'imal'is'	unkn	занимались
zanimasi	unkn	занимать
zap'ihival'i	unkn	запихивали
zapasi	unkn	запас
zapat	unkn	запад
zapisyvajit	unkn	записывает
zapisyvali	unkn	записывали
zarabotanij	unkn	заработанные
zarabәtkә	unkn	заработка
zaran'iji	unkn	заранее
zaran'ijə	unkn	заранее
zarplati	unkn	зарплата
zarplatə	unkn	зарплата
zato	unkn	зато
zatsəpilśa	unkn	зацепился
zatwor	stem	затвор
zav'əršajušij	unkn	завершающий
zavoračivala's	unkn	заворачивалась
zawhohi	unkn	завхоз
zašival'i	unkn	зашивали
zašišati	unkn	защищать
zd'əlani	unkn	сделаны,,сделаны
zdaj	stem	сдать
zdava	unkn	сдавать
zdawaj	SLIP	сдавать.SLIP
zdrāstwujt'e	unkn	здравствуйте
zdāńi	stem	сдавать
zemlu	unkn	землю
zimn'iji	unkn	зимние
zimniji	unkn	зимние
zimowja	unkn	зимовья
zna	unkn	значит.SLIP
znajim	unkn	знаем
znaju	unkn	знаю
znajəš	unkn	знаешь
znala	unkn	знала
znatnij	unkn	знатный
znatto	unkn	знать.то
značit	unkn	значить,значит
znəkomiji	unkn	знакомый
zoow'ətťehnikum	unkn	зооветтехникум
zra	unkn	зря
zveroferma	stem	звероферма
zweroferma	unkn	звероферма
zzadi	unkn	сзади
zďə	unkn	с.детства.SLIP
zďәś	unkn	здесь
zəkəza	unkn	заказывать
zәxvәtili	unkn	захватили
z’imoj	unkn	зимой
z’imy	unkn	зимы
«Маленькая» значит.	unkn	«Маленькая» значит.
«Сулакан» называлась.	unkn	«Сулакан» называлась.
ā	stem	спать
ā	unkn	спать
āg	unkn	причалить
āmki	unkn	полог
āmut	unkn	озеро
ānŋə	unkn	ночевка
ārī	unkn	позвать
ās'in	unkn	NEG
ās	unkn	спать.SLIP
āči	unkn	NEG
āčin	unkn	NEG
āŋ	unkn	это
āŋi	unkn	это
āŋnə	unkn	ночевать
āśi	unkn	NEG
āśin	unkn	NEG
ăbratnə	unkn	обратно
ča	unkn	чай
čagida	unkn	место.подальше
čaj	stem	чай
čaj	unkn	чай
čaji	unkn	чай
čalba	stem	береза
čalban	stem	береза
čalban	unkn	береза
čalbu	unkn	береза.SLIP
čamba	unkn	Чамба
čanku	unkn	санки
čapumə	unkn	пеший
čas	unkn	час
časof	unkn	часов
čast'i	unkn	части
čat	unkn	чай
čaŋgada	unkn	Чангада
čaŋgāda	unkn	Чангада
čaŋit	stem	разбойник
čaŋit	unkn	разбойник
čaŋiti	unkn	разбойник
čaŋki{*}	unkn	санки
čaŋku	unkn	санки,санки.SLIP
čemo	unkn	орех
čeno	unkn	орех
čerez	unkn	через
čikil	unkn	спрятаться
čikti	unkn	бисер,Чикты
činmōn	stem	отскочить
činə	unkn	густой.пучок.из.веток
čip	unkn	HES
čipka	unkn	утка
čipkā	unkn	соболь
čipkā	stem	соболь,птица
čipkā	unkn	соболь,утка,волк
čipkān	unkn	соболь,волк
čirinda	unkn	Чиринда
čiris	unkn	через
čirka	unkn	чиркан
čiskowoj	unkn	Чисковая
čisla	unkn	числа
čislah	unkn	числах
čisto	unkn	чисто
čistyj	unkn	чистый
čistə	unkn	чистый
čistəj	unkn	чистый
čitir'i	unkn	четыре
čo	unkn	что,чо
čok	stem	убить
čok	unkn	убить,прицелиться,прицелиться.SLIP
čokoksōn	stem	прицел
čolī	stem	язык
čolī	unkn	болтать
čombo	unkn	потерять
čonit'	unkn	что.нибудь
čopumo	unkn	пеший
čopuči	unkn	медведь
čotə	unkn	что.то
čotә	unkn	что.то
čtop	unkn	чтоб,чтобы
čulugdɨ	stem	Чулугды
čuluk	stem	чулук[топот.Чулугды]
čum'ə	unkn	чуме
čum	unkn	чум
čuma	unkn	чума
čumačik	unkn	чумачик
čumə	unkn	чума
čurgī	stem	просочиться
čurnigar'u	unkn	чур.не.горю
čuwaka	unkn	сопка
čā	stem	место.недалеко
čā	unkn	место.недалеко
čāski	unkn	далеко,дальше
čāskī	stem	подальше
čāskī	unkn	подальше
čātirə	unkn	песец
čērkā	stem	кричать
čīwā	unkn	делать.нити.из.жил
čəm	unkn	чем
čəranki	stem	гон
čərankitɨ	stem	гон
čərurgǝ	unkn	затихать
čətyrə	unkn	четыре
čəwo	unkn	чего
č’itv’ortəj	unkn	четвертый
č’ortsńim	unkn	черт.с.ним
ďa	SLIP	SLIP,росомаха.SLIP
ďa	stem	родственник,друг
ďa	unkn	SLIP,десять.SLIP,друг,родственник,лодка.SLIP
ďadaŋi	unkn	бедный(безоленный)
ďagda	stem	сосна
ďagda	unkn	сосна
ďaja	stem	спрятать,спрятаться
ďaja	unkn	спрятать
ďaju	unkn	спрятать
ďal	stem	мысль
ďaldā	stem	размышлять
ďami	unkn	Дями
ďan	stem	десять
ďan	unkn	десять
ďantakī	unkn	росомаха
ďantakī	stem	росомаха
ďantakī	unkn	росомаха
ďap	stem	лодка.берестянка
ďapka	stem	берег
ďapka	unkn	берег
ďapku	unkn	восемь
ďapkun	stem	восемь
ďapkun	unkn	восемь
ďapkunďar	unkn	восемьдесят
ďapkutal	unkn	по.восемь
ďaptili	unkn	продукт
ďar	unkn	десять
ďaru	stem	подпеть
ďavi	unkn	лодка
ďaw	stem	отозваться,лодка.берестянка
ďaw	unkn	лодка.берестянка
ďawa	stem	схватить
ďawa	unkn	схватить,поймать
ďawi	stem	лодка.берестянка
ďawi	unkn	лодка
ďawrā	SLIP	лодка.VBLZ.SLIP
ďawu	stem	схватить
ďawu	unkn	SLIP,схватить,лодка.SLIP
ďawura	unkn	лодка.SLIP
ďawusa	stem	держать
ďawuča	stem	держать
ďawuča	unkn	держать
ďawūśə	unkn	держать
ďawə	unkn	SLIP
ďaďa	stem	дядя
ďaďa	unkn	дядя
ďeb	unkn	есть
ďebŋənə	unkn	объедки
ďelať	unkn	делать
ďem	unkn	съесть
ďet	unkn	дедушка,дед
ďi	SLIP	SLIP
ďi	stem	вложить
ďigalī	unkn	Дигали
ďijstvitelno	unkn	действительно
ďikab	unkn	SLIP
ďiko	stem	спрятаться
ďiko	unkn	спрятаться
ďiktə	stem	ягода
ďiktə	unkn	ягода
ďirika	unkn	бугор
ďiržať	unkn	держать
ďiv'atsot	unkn	девятьсот
ďiwo	stem	удивиться
ďižur’i	unkn	дежурить
ďižur’it'd'ə	unkn	slip
ďo	unkn	желчь,SLIP
ďogor	unkn	нехватка,нужда
ďom	unkn	съесть
ďon	stem	вспомнить
ďon	unkn	SLIP,помнить
ďoni	unkn	вспомнить
ďonťa	unkn	помнить
ďonə	stem	вспомнить
ďoro	unkn	лицо
ďoromi	stem	украсть
ďoromo	stem	украсть
ďu	SLIP	чумовище.SLIP
ďu	stem	дом.чум,два
ďu	unkn	два.SLIP,чум,дом.чум,чум.SLIP,настать(о.лете).SLIP,дом.чум.SLIP,SLIP,два,дом
ďu=	unkn	дом.SLIP
ďuga	stem	летом,настать(о.лете)
ďuga	unkn	летом,настать(о.лете)
ďugan’	unkn	лето.SLIP
ďugu	unkn	перенести
ďuktə	stem	двое
ďuktə	unkn	двое
ďukča	stem	чумовище
ďukča	unkn	чумовище
ďukťa	unkn	двое
ďukə	stem	лед
ďukə	unkn	лед.речной,лед
ďukə̄	unkn	лед(речной)
ďular	unkn	дом.чум.SLIP
ďuleški	unkn	вперед
ďuloski	unkn	вперед,впредь
ďulōskī	stem	вперед
ďulōskī	unkn	вперед
ďulə	unkn	перед
ďuləmə	SLIP	прийти.раньше.SLIP
ďulə̄	unkn	место.впереди
ďuma	unkn	дом.чум
ďupkun	unkn	Дюпкун
ďur	stem	два
ďur	unkn	два
ďuru	unkn	два
ďurďar	unkn	двадцать
ďurə	unkn	два
ďurε	unkn	два
ďuwa	unkn	SLIP,дом.чум.SLIP
ďuwu	stem	перенести
ďuwū	unkn	перевозить
ďū	unkn	дом
ďuγa	stem	летом
ďuγa	unkn	летом,настать(о.лете)
ďuγū	stem	перетащить
ďuγū	unkn	перевезти,переезд
ďuγə	unkn	летом
ďzān	unkn	десять
ďā	unkn	родственник,друг
ďāw	unkn	отозваться
ďēlī	unkn	таймень
ďīγit	unkn	из.леса
ďū	stem	дом.чум
ďū	unkn	дом,дом.чум,чум
ďūktә	unkn	вдвоём
ďūr	stem	два
ďūr	unkn	два
ďūrǝ	unkn	два
ďə	SLIP	SLIP
ďə	stem	съесть
ďə	unkn	съесть.SLIP,есть,SLIP,съесть
ďəb	stem	съесть
ďəb	unkn	есть,съесть
ďəduška	unkn	дедушка
ďəduškami	unkn	дедушками
ďəf	stem	съесть
ďəf	unkn	съесть
ďəfsamda	unkn	объедок
ďəgin	stem	левый
ďəgďi	unkn	зажечь
ďəlať	unkn	делать
ďəli	unkn	таймень
ďəlimakit	unkn	Делимакит
ďəlum	stem	тайный
ďəlī	unkn	таймень
ďələki	unkn	горностай
ďələkī	unkn	горностай
ďəm	stem	съесть
ďəm	unkn	съесть
ďən	unkn	левый
ďəngi	unkn	деньги
ďəp	stem	съесть
ďəp	unkn	SLIP,съесть,есть,кушать
ďəp=	stem	съесть.SLIP
ďəpi	stem	съесть
ďəpti	unkn	людоед
ďəptilə	stem	продукт
ďəptilə	unkn	еда,продукт
ďəptəl	unkn	продукт
ďəptɨlə	stem	продукт
ďəpďə	unkn	съесть.IPFV.SLIP
ďərinə	stem	мелькать
ďəržis	unkn	держись
ďərəwńa	stem	деревня
ďəw	stem	съесть
ďəw	unkn	есть,съесть
ďəwu	stem	съесть
ďəwu	unkn	есть,съесть
ē	root	что
ē	stem	что
ē	unkn	что
ēda	stem	зачем
ēdā	stem	зачем
ēha	stem	глаз
ēha	unkn	глаз
ēku	stem	что
ēku	unkn	что
ēkun	stem	что
ēkun	unkn	что
ēkuni	unkn	что
ēkuśi	unkn	что.SLIP
ēwa[нрзб]	[нрзб]	[нрзб]
ēwuna	stem	зачем
ī	stem	войти,выделать(о.шкуре)
ī	unkn	где,выделать,войти,INTER,войти.SLIP
īdu	unkn	где
īduk	unkn	отсюда,откуда
īdū	stem	где
īdū	unkn	где
īdəhəni	unkn	выбрать
īkə̄rī	unkn	хребет
īla	stem	три
īla	unkn	три
īlo	unkn	куда
īlā	unkn	сюда,куда
īlō	stem	сюда
īlō	unkn	где,сюда,куда
īlə	unkn	куда
īlən	unkn	три
īlə̄	unkn	куда
īn	unkn	жизнь
īrgi	unkn	воспитывать
īŋanī	unkn	день
ńama	stem	тепло,теплеть
ńama	unkn	тепло
ńamad'i	unkn	сотня
ńamadi	unkn	сто,сотня
ńamad’i	unkn	сто
ńamasal	unkn	важенка.PL
ńamat’ə	unkn	сто
ńamaďi	stem	сто
ńamādī	unkn	сотня
ńami	unkn	важенка
ńamis’an	unkn	важенка
ńamā	unkn	сто
ńan	stem	опять
ńan	unkn	опять
ńanmakta	unkn	комар
ńanə	unkn	опять,весной
ńarala	stem	лежать[нет.в.словаре]
ńańčit	unkn	нянчить
ńaŋta	unkn	кедровая.шишка
ńaŋu	unkn	возражать
ńaŋńa	unkn	грязь
ńaŋńa.	unkn	весной
ńān	unkn	опять
ńe	unkn	не
ńekə	unkn	собираться
ńekəŋdə	unkn	Эконда.SLIP,Эконда
ńet	unkn	нет
ńewo	unkn	него
ńē	unkn	нет
ńi	unkn	ни,SLIP,кто,что,корень.SLIP,не
ńibal	RUS	небольшой
ńidim	unkn	Нидым
ńigə	stem	проклясть
ńihū	stem	отвезти.тушу
ńihəli	unkn	распахнуть
ńikagda	unkn	никогда
ńikak	unkn	никак
ńikalaičəm	unkn	Николаевичем
ńiko	unkn	собираться,собраться
ńikolajəvič	unkn	Николаевич
ńikī	unkn	утенок
ńikə	stem	собираться
ńikə	unkn	собираться
ńimati	stem	делать.пай.от.охоты
ńimnogo	unkn	немного
ńimnoška	unkn	немножко
ńimnoškato	unkn	немножко.то
ńimnoško	unkn	немножко
ńimok	stem	сосед
ńimoki	stem	сосед
ńimu	unkn	ослабеть(об.органе)
ńimŋə	stem	голод
ńimŋə	unkn	проглотить
ńina	unkn	Нина
ńirus'a	unkn	хариус
ńirus'an	unkn	хариус
ńiskī	unkn	вниз.по.склону
ńiwo	unkn	него
ńičəwo	unkn	ничего
ńiďelu	unkn	неделю
ńiďeľa	unkn	неделя
ńiŋtə	stem	корень
ńiŋī	unkn	проклясть
ńoko	unkn	собираться,собраться
ńoγut	unkn	сначала
ńulgi	unkn	кочевать
ńuriktə	stem	волосы
ńurma	stem	подкрасться
ńurmā	unkn	подкрасться
ńutə	stem	смола.лиственницы
ńuŋi	unkn	шестой.SLIP,шестой
ńuŋu	unkn	шестой.SLIP
ńuŋun	stem	шесть
ńuŋun	unkn	шесть
ńuŋuńd’ar	unkn	шестьдесят
ńuŋńaki	unkn	гусь
ńuŋən	unkn	шесть
ńādimə̄	unkn	получить.в.подарок
ńān	unkn	опять
ńēlifsi	unkn	угрожать[точный перевод неясен; неясно, почему "язык" в именительном падеже]
ńēskī	unkn	вниз.по.склону
ńī	stem	кто
ńī	unkn	что,кто
ńə	unkn	SLIP,не
ńə=	unkn	SLIP
ńəkatorij	unkn	некоторый
ńəkə	stem	собираться
ńəkə	unkn	сорога,собираться
ńəkəŋdə	unkn	Эконда
ńəmnogo	unkn	немного
ńəmulə	stem	мягкий
ńəmumo	stem	мягкий
ńəďəla	unkn	неделя
ńəŋńə	stem	ранней.весной
ńəŋńə	unkn	настать(о.весне),проводить(о.весне)
ńəŋə	stem	проклясть
ńәkә	unkn	собираться
ŋ'umi	unkn	шестой.SLIP
ŋ'umī	unkn	шестой
ŋa	unkn	SLIP
ŋalə	unkn	рука
ŋan	unkn	комар.SLIP
ŋanmakta	unkn	комар
ŋālə	unkn	рука
ŋi	unkn	SLIP,кто
ŋinaki	stem	собака
ŋinaki	unkn	собака.SLIP,собака
ŋinakil	unkn	собака.SLIP
ŋinakin	stem	собака
ŋinakin	unkn	собака.SLIP,собака
ŋinaγī	unkn	пустить.собаку
ŋo	unkn	положить,вонь
ŋoli	unkn	испугаться
ŋolo	unkn	испугаться
ŋolomo	unkn	грех
ŋolə	unkn	бояться,испугаться
ŋolә	unkn	бояться,испугаться
ŋōli	unkn	бояться
ŋōlə	unkn	испугаться
ŋāli	unkn	рука
ŋālə	stem	рука
ŋālə	unkn	рука
ŋī	unkn	кто
ŋō	unkn	вонь
ŋōkonno	stem	Наканно(село)
ŋōkonnot	stem	Наканно(село).SLIP
ŋōli	stem	испугаться
ŋōli	unkn	испугаться
ŋōlə	stem	испугаться
ŋōlə	unkn	бояться,испугаться
ŋōləp	SLIP	испугаться.CAUS.SLIP
ŋōnim	stem	длинный
ŋōnim	unkn	длинный
ŋōnimi	unkn	длинный
ŋōńim	stem	длинный
ŋōńimi	stem	длинный
ŋəkə	unkn	собираться
ŋəkəndə	unkn	Эконда
ŋəli	stem	испугать,испугаться
ŋəli	unkn	испугать,испугаться
ŋəlifśə	stem	страшный
ŋəlifśə	unkn	страшный
ŋələ	stem	испугаться
ŋələ	unkn	SLIP,испугаться
ŋələfśi	stem	страшный
ŋəni	stem	мастерица.шить
ŋəni	unkn	мастерица.шить
ŋənu	unkn	возвращаться
ŋənə	stem	идти
ŋənə	unkn	прийти,ехать,пойти,пройти,ездить,весной,идти,идти.SLIP
ŋənəčo	unkn	идти.PST.SLIP
ŋənə̄	unkn	идти
ŋəpkəkə̄	unkn	кочка
ŋəŋə	unkn	идти,весной
ŋə̄l	stem	испугать
ŋə̄lə	stem	испугать
ŋə̄lə	unkn	испугать,испугаться
ŋə̄ləwsi	stem	страшный
ŋə̄ləwsi	unkn	страшный
ŋə̄ləws’e	unkn	страшный
ŋə̄rī	stem	светлый,светить
ŋə̄rī	unkn	свет,светить
ŋə̄ski	unkn	вниз.по.склону
ŋ́əkəndə	unkn	Эконда
ō	stem	сделать,стать,INTJ
ō	unkn	о,сделать,стать,делать,INTJ,NEG
ōha	stem	камыс
ōha	unkn	камыс
ōhīkta	stem	звезда
ōj	unkn	INTJ
ōkin	stem	когда
ōkir	stem	когда
ōkir	unkn	когда
ōkī	stem	сколько
ōkī	unkn	сколько
ōkīn	unkn	сколько,когда
ōn	stem	как
ōn	unkn	как
ōri	unkn	позвать
ōrī	unkn	вызвать
ōŋ	unkn	как
ōŋkān	unkn	упасть.навзничь
ōγa	unkn	камыс
śajńiki	stem	чайник
śas	unkn	сейчас
śera	unkn	сера
śi	unkn	сильно.SLIP,SLIP
śigdələ̄	stem	промежуток
śih	unkn	сих
śiko	SLIP	мочиться.SLIP
śikə	stem	мочиться
śikən	stem	мочиться
śila	unkn	жарить.на.вертеле
śilami	unkn	силами
śilno	unkn	сильно
śilo	unkn	село
śimja	stem	семья
śimja	unkn	семья
śimka	stem	срединная.жердь
śimūrga	stem	стихнуть
śin	stem	2SG
śint'abr'	unkn	сентябрь
śinťabr	unkn	сентябрь
śinťabre	unkn	сентябре
śinə	stem	2SG.ACC
śipkā	stem	птица
śipkā	unkn	соболь,птица
śirinda	stem	Чиринда
śirinda	unkn	Чиринда
śirəktə	stem	жила
śistra	unkn	сестра
śita	unkn	глина,грязь
śiďmom	unkn	седьмом
śkolnij	unkn	Школьный
śo	unkn	SLIP
śuda	unkn	сюда
śuka	unkn	трава
śukə	stem	трава
śulugdi	stem	Чулугды
śulugdi	unkn	Чулугды
śulugdɨ	stem	Чулугды
śum	unkn	уменьшиться
śāskī	stem	подальше
śī	stem	2SG
śītā	unkn	грязь
śūkə	unkn	трава
śūmi	unkn	уменьшиться
śəwərnaj	stem	северный
śəďmom	unkn	седьмом
śәd’moj	unkn	седьмой
š'oto	unkn	что.то
š	unkn	SLIP
ša	unkn	знать,старый.SLIP
šabda	unkn	соболь
šadu{*}	unkn	там
šag	unkn	старый.SLIP
šagdi	unkn	старый
šaman	stem	шаман
šaman	unkn	шаман
šamani	stem	шаман
šamašil	unkn	шаман.PL
šan	unkn	протока[???]
šapka	unkn	привыкнуть
šas	unkn	сейчас
šatun	unkn	шатун
ši	unkn	бык.SLIP,снег.SLIP
šini	unkn	снег.SLIP
šinilgan	unkn	снег
šinilgə	unkn	снег.SLIP
šinilgən	unkn	снег
širu	unkn	бык
šisdisat	unkn	шестьдесят
šistom	unkn	шестом
šiγun	unkn	солнце
škola	unkn	школа,лаять
školi	unkn	школы
školu	unkn	школу
šo	unkn	SLIP,сильный(о.проявлении.качества),теленок.SLIP
šobd'o	unkn	соболь
šobda	unkn	соболь
šobdon	unkn	соболь
šolila	unkn	в.верховьях
šoŋnōktə	unkn	теленок
šō	unkn	сильный(о.проявлении.качества)
šta	unkn	что
što	unkn	что
štob	unkn	чтоб,чтобы
štobi	unkn	чтобы
štoby	unkn	чтобы
štoli	unkn	что.ли
štop	unkn	чтоб,чтобы
štēnberk	unkn	Штенберг
šu	stem	верхняя.одежда
šu	unkn	камысная.лыжа.SLIP,пойти.SLIP
šuksilra	unkn	камысная.лыжа
šukši	unkn	лыжа
šukšilra	unkn	камысная.лыжа
šukšilrə	unkn	камысная.лыжа
šukšinisā	unkn	лыжня
šulakī	unkn	лиса
šun	stem	2PL
šura	unkn	Шура
šuru	stem	пойти
šuru	unkn	уехать,пойти.SLIP,пойти
šō	stem	сильный,очень
šōm	stem	закрыть
šōmi	stem	закрыть
šū	stem	2PL
šəsďəśat	unkn	шестьдесят
š’'irinda	unkn	Чиринда
š’as	unkn	сейчас
ťip	unkn	чип
ťiper	unkn	теперь
ťē	unkn	???
ťəpər	unkn	теперь
ūkōŋ	stem	гагара
ūrə	unkn	мясо
ūča	unkn	ездить.верхом
ūčak	stem	верховой олень
ūčak	unkn	верховой олень,верховой.олень
ūčaki	unkn	верховой олень,верховой.олень
ūďa	unkn	след,дорога
ūďə	unkn	след
ūśə̄	unkn	давность
žarko	unkn	жарко
že	unkn	FOC,же
žerďi	unkn	жердь
žil'i	unkn	жили
žili	unkn	жили
žimolost	unkn	жимолость
žir	unkn	жир
žisn'	unkn	жизнь
žit	unkn	жить
živu	unkn	живу
žiz’n’	unkn	жизнь
žə	stem	же
žə	unkn	же
žələwəji	unkn	железный
žərd'i	unkn	жерди
žərďi	unkn	жердь.SLIP
ǝ	unkn	SLIP,NEG
ǝta	unkn	это
ǯə̄n	unkn	забыть
ɔ	unkn	NEG
ə	INTJ	INTJ
ə	SLIP	SLIP
ə	stem	этот,SLIP,NEG,что
ə	unkn	этот,что,да,NEG.SLIP,это,HES,SLIP,э,NEG,INTJ,а,не.стать,neg,INTER,что.SLIP
ə=	unkn	NEG.SLIP
əb	SLIP	бабушка.SLIP
əbōj	stem	ах!
əbōj	unkn	ах!
əbəj	stem	ах!
əbəj	unkn	ах!,INTJ
əbəjkə̄kūn	unkn	очень.страшный
əbəkō	stem	бабушка
əbəkō	unkn	бабушка
əbəkə	unkn	бабушка
əbəkə̄	unkn	бабушка
əbə̄j	unkn	ах!
əda	stem	зачем
ədgar	unkn	Эдгар
ədi	unkn	муж
ədin	unkn	один,ветер
ədnom	unkn	одном
ədo	unkn	SLIP
ədu	unkn	здесь
əduk	stem	отсюда
əduk	unkn	отсюда
ədū	unkn	здесь
ədā	stem	зачем
ədān	stem	шалить
ədī	unkn	муж
ədū	adv	здесь
ədū	stem	здесь
ədū	unkn	там,здесь,теперь
ədūk	unkn	отсюда
ədɨ	stem	муж
əh	unkn	SLIP
əha	unkn	тронуть,глаз
əhi	stem	сейчас
əhi	unkn	сейчас
əhot’əcə	unkn	охотятся
əhī	stem	сейчас
əhī	unkn	сейчас
əhə	unkn	SLIP
əjda	unkn	понять
əjdə	stem	заметить
əji	unkn	SLIP
əjo	unkn	плыть.по.течению
əjokī	stem	вниз.по.течению
əjī	stem	утопить
əjī	unkn	утонуть
əjōn	unkn	течь
əjə	unkn	утонуть
əjə̄	stem	плыть.по.течению
əjə̄	unkn	плыть.по.течению,утонуть,тонуть
əjə̄n	stem	плыть.по.течению
əjə̄n	unkn	плыть.по.течению
əjə̄nə	unkn	плыть.по.течению
əjə̄t	unkn	просить
ək	unkn	SLIP
əki	unkn	старшая.сестра
əknīl	unkn	старшая.сестра.PL
əkspedicija	unkn	экспедиция
əkspediciji	unkn	экспедиция
əkspeditsijə	unkn	экспедиция
əkspeďitsijə	unkn	экспедиция
əkspəd’itsijə	unkn	экспедиция
əkspəďitśjə	unkn	экспедиция
əksə	unkn	возить,везти
əks’ə	unkn	везти
əku	stem	что
əku	unkn	что,какой,кто
əkun	stem	что
əkun	unkn	что,какой,INDEF
əkī	unkn	старшая.сестра
əkīn	stem	старшая.сестра
əkīn	unkn	старшая.сестра
əkīni	unkn	старшая.сестра
əkńil	unkn	старшая.сестра.PL
əkśə	unkn	вести,везти
əkə	unkn	хотеть
əl	unkn	SLIP,эй
əla	unkn	весь,сюда
əlaha	unkn	когда
əlbaskəsi	unkn	купаться
əlbat	unkn	защищать
əlbəskə̄t	stem	купаться
əlbət	unkn	защитить
əldu	stem	покрышка.для.чума
əldun	stem	покрышка.для.чума
əldunda	unkn	покрышка
əlgə	unkn	вести.на.поводу
əličəpil	unkn	?
əlko	unkn	еще
əlkə	unkn	еще
əlō	unkn	сюда
əlun	unkn	бездорожье
əlā	stem	сюда
əlā	unkn	сюда
əlīp	stem	стараться
əlō	stem	сюда
əlō	unkn	сюда
əlōlī	unkn	как.раз.в.это.время
ələ	stem	весь,вот
ələ	unkn	slip,SLIP,вот,весь
ələdə	unkn	все.таки,совсем
ələkin	stem	достаточный
ələkīn	unkn	достаточный
ələkə̄s	stem	сначала,впервые
ələkə̄s	unkn	вначале
ələndu	unkn	SLIP
ələt	unkn	[перевод неясен]
ələ̄	stem	сюда
ələ̄	unkn	сюда,основной
ələ̄də̄	unkn	постараться
ələ̄lī	unkn	как.раз
ələ̄̄	unkn	сюда
əl’en’i	unkn	олени
əl’ə	unkn	вот
əm	SLIP	люлька.SLIP
əm	unkn	прийти
əmkə	stem	люлька
əmkə	unkn	люлька
əmon	unkn	оставить
əmty	unkn	<неясная.форма>
əmugdə	stem	внутренность
əmukin	stem	один(о.человеке)
əmukin	unkn	один[о.человеке]
əmā	stem	зачем.делать
əmŋəŋi	unkn	вместительный
əmə	stem	прийти
əmə	unkn	прийти,прийти.SLIP,прибыть,приехать,пойти,приходить,SLIP,оставить
əməgən	unkn	седло.для.человека
əməgəni	unkn	седло.для.человека
əməgənə	unkn	седло.для.человека
əmən	stem	оставить
əmən	unkn	оставить
əmənmus	unkn	оставить.SLIP
əməwən	unkn	прийти.SLIP
əməďəs=	unkn	прийти.SLIP
əmə̄n	stem	оставить
əmə̄n	unkn	оставить
əmə̄ni	unkn	оставить
ən	unkn	SLIP,болеть(об.органе).SLIP
əni	unkn	мать
ənin	unkn	мать.SLIP,мать
ənini	unkn	мать
ənir	unkn	мать.SLIP
ənī	unkn	мать
ənīn	unkn	мать
əntil	unkn	родитель.PL
əntili	unkn	родитель.PL
əntɨl	stem	родитель.PL
əní	unkn	мать
ənī	unkn	мать
ənīn	unkn	мать
ənŋə	stem	уважать
ənə	unkn	она
ənəli	unkn	лениться
ənəlŋə	stem	лень,ленивый
ənəŋgə	stem	ленивый
ənə̄l	stem	лениться
ən’in	unkn	мать
əp'at'	unkn	опять
əp	unkn	SLIP
əpať	stem	опять
əpet	stem	опять
əpet	unkn	опять
əptilə	stem	ребро
əptilə	unkn	ребро
əptɨ	stem	обрызгать
əpət	stem	опять
əpət	unkn	опять
əp’at	unkn	опять
əp’ət’	unkn	опять
ər	stem	разгребать.снег,звать,этот
ər	unkn	этот,эта,вот,это
ərban	unkn	столько
ərdi	unkn	такой
ərdəlo	unkn	до.сих.пор
ərdəlon	unkn	совсем
ərdəlān	unkn	до.сих.пор
ərdəlōn	stem	до.сих.пор
ərdəlōn	unkn	до.сих.пор
ərdələ̄n	unkn	до.сих.пор
ərg’išim	unkn	аргишим
əri	stem	этот
əri	unkn	этот
ərjoklō	unkn	в.эту.сторону
ərkor	unkn	это
ərkəməju	unkn	место.почти.здесь
əro	unkn	этот.ACC
ərtikī	unkn	сюда,туда
ərtəki	unkn	туда
əru	SLIP	несчастье.SLIP
əru	stem	несчастье
əru	unkn	зло,несчастье
ərudə	stem	нервничать
ərukta	unkn	пробовать,высмотреть
əruktə	unkn	рассмотреть
ərupču	unkn	плохой
əruwśu	unkn	плохой
ərū	unkn	плохой
ərū̄	unkn	плохой
ərī	unkn	дышать
ərə	stem	этот
ərə	unkn	этот,этот.ACC,это
ərəgəri	stem	все.время
ərəgəri	unkn	всегда,все.время,совсем
ərəgərit	unkn	совсем
ərəp	unkn	NEG.SLIP
ərə̄	unkn	этот
ərε	unkn	здесь
əs'o	unkn	еще
əsile	unkn	теперь
əsilə	unkn	теперь
əsī	unkn	сейчас
əsīlə	unkn	теперь
əsli	unkn	если
əsso	unkn	еще
əssə	stem	еще
əssə	unkn	еще
əsī	unkn	сейчас,сегодня
əsīlə̄	unkn	теперь
əsə	unkn	еще
ət	unkn	slip,SLIP,старик.SLIP
əta	unkn	эта,это
ətam	unkn	этом
ətamu	unkn	этому
ətawa	unkn	этого
əti	unkn	эти
ətih	unkn	этих
ətim	unkn	этим
ətir	unkn	SLIP
ətirko	unkn	старик
ətirkon	unkn	старик[эвфемизм.для.медведя]
ətirkōn	unkn	муж
ətirkān	unkn	старик
ətirkō	unkn	старик
ətirkōn	stem	старик
ətirkōn	unkn	старик,муж
ətirkōni	stem	старик
ətirkōni	unkn	старик,муж
ətirkə	unkn	старик
ətirkən	stem	старик
ətirkən	unkn	старик
ətirkəni	stem	старик
ətirkə̄	unkn	старик
ətirkə̄n	unkn	муж
ətki	unkn	свекор
ətn	unkn	SLIP
ətnografičeskaj	unkn	этнографический
əto	unkn	это
ətot	unkn	этот
ətova	unkn	этого
ətovo	unkn	этого
ətprəvl’ajut	unkn	отправляют
ətprəvl’ali	unkn	отправили
ətyrkon	unkn	старик
ətyrkō	unkn	[при.расшифровке:старик
ətyrkōn	unkn	старик
ətyrkōn	unkn	старик
ətīrko	unkn	старик
ətō	stem	не.стать
ətə	stem	не.стать
ətə	unkn	SLIP,NEG,не.стать,это
ətəjet	unkn	караулить
ətəji	unkn	стеречь
ətəjə	unkn	стеречь
ətəjət	unkn	стеречь,пасти
ətəjə̄	unkn	караулить
ətət	unkn	этот
ətəw	unkn	NEG.SLIP
ətəØn	unkn	не.стать.SLIP
ətə̄	unkn	не.стать
ətɨ	stem	разорваться
ətɨ	unkn	эти
ətɨr	unkn	разорваться.SLIP
ətɨrkō	stem	старик
ətɨrkōn	stem	старик
ətɨrkōni	stem	старик
ətɨrkōni	unkn	старик
ətɨrkə̄n	stem	старик
ətɨrkə̄ni	stem	старик
əvənkiju	unkn	Эвенкию
əvənkof	unkn	эвенков
əw	stem	спуститься
əw	unkn	SLIP
əwgidā	unkn	эта.сторона
əwgiski	unkn	сюда.вниз
əwgiskī	unkn	сюда.вниз
əwi	unkn	играть.SLIP,играть
əwlon	unkn	жалеть
əwlə	unkn	жалеть
əwu	stem	спуститься
əwurkat	stem	шептать[???]
əwus	unkn	спуститься
əwū	unkn	спускаться
əwī	stem	играть
əwī	unkn	играть
əwīl	unkn	играть.INCH.SLIP
əwīwuron	unkn	играть.SLIP
əwə	stem	эвенк
əwə	unkn	SLIP,эвенк,эвенкийский,играть
əwə=	unkn	эвенк.SLIP
əwədy	unkn	эвенкийский
əwədyt	unkn	эвенкийский
əwən	unkn	эвенк.SLIP
əwənki	unkn	эвенк
əwənkī	stem	эвенк
əwənkī	unkn	эвенк
əwəski	unkn	назад
əwəŋki	stem	эвенк
əwəŋki	unkn	эвенк
əwəŋkī	stem	эвенк
əwəŋkī	unkn	эвенк
əďi	unkn	низовье
əďī	stem	низовье
əďən	unkn	NEG.SLIP
əľī	unkn	где
əń	unkn	мама
əńi	stem	мать
əńi	unkn	мать
əńin	stem	мать
əńin	unkn	SLIP,мать
əńini	unkn	мать
əńī	unkn	мама,мать
əńo	unkn	мама
əńō	unkn	мама
əńī	stem	мать
əńī	unkn	мать
əńī=	unkn	мать.SLIP
əńīn	stem	мать
əńīn	unkn	мать
əńīni	stem	мать
əńīni	unkn	мать
əŋnəko	unkn	теленок.до.года
əŋnəkō	unkn	теленок
əŋnəkōn	unkn	теленок
əŋnəkə̄	unkn	теленок оленя
əŋtə	unkn	хоркать
əŋəhī	stem	сила
əŋəhī	unkn	сила
əŋənī	stem	сильно
əŋəńī	stem	сильно
əśi	SLIP	SLIP
əśī	stem	сейчас
əśə	stem	еще
əš'o	unkn	еще
əša	unkn	глаз
əťi	unkn	эти
əťikunka	unkn	???
əˀ	stem	INTJ
ə̄	stem	что,INTJ
ə̄	unkn	этот,нет,INTJ,что,да,это,HES
ə̄duk	unkn	отсюда,откуда
ə̄dū	unkn	здесь
ə̄dūk	unkn	отсюда
ə̄gda	stem	какой
ə̄ha	unkn	глаз
ə̄j	stem	INTJ
ə̄jan	unkn	???
ə̄ku	unkn	что
ə̄kun	unkn	что
ə̄kuni	unkn	что
ə̄kūn	unkn	что,кто
ə̄kūn	unkn	что,кто/что
ə̄laha	stem	когда
ə̄laha	unkn	всегда/в.какой.период,когда
ə̄ri	stem	звать
ə̄ri	unkn	звать
ə̄s	stem	отогнать
ə̄t	unkn	чем
ə̄to	unkn	это
ə̄wūn	unkn	зачем
əγi	unkn	сейчас,играть
əγī	unkn	сейчас
əγə	unkn	INTJ
ɲamaďi	stem	сто
ɲi	root	кто
ɲō	stem	вспотеть
ɲōwu	stem	передовой
ɲəkə	stem	собираться
ɲəkə	unkn	собираться
γoro	unkn	давнее.время
γr’išə	unkn	Гриша
γurusī	unkn	грузить
γēwa	unkn	вторично
γō	unkn	сильный(о.проявлении.качества)
γōta	unkn	делать.изгородь
χ	unkn	SLIP
В Нидыме еще работала я полгода	 тоже на звероферме.	В Нидыме еще работала я полгода, тоже на звероферме.
Дарьякан [Маленькая Дарья]	 поэтому и внучку назвала Дашей.	Дарьякан [Маленькая Дарья], поэтому и внучку назвала Дашей.
Дарьякан [Маленькая Дарья]	unkn	Дарьякан [Маленькая Дарья]
И вот ее все время	 Дарьякан [Маленькая Дарья] прозвали.	И вот ее все время, Дарьякан [Маленькая Дарья] прозвали.
И вот она постоянно	 когда я со школы приезжала	И вот она постоянно, когда я со школы приезжала, она все время ждала...
На звероферме работала.	unkn	На звероферме работала.
Нет	 я жила там.	Нет, я жила там.
Ну единственная же.	unkn	Ну единственная же.
Она всю жизнь	 считай	Она всю жизнь, считай, так и прожила там, сторожила звероферму, там и жила.
Потому что она щупленькая вот такая	 бабушка.	Потому что она щупленькая вот такая, бабушка.
Про это я не сказала	 потому что это как-то...	Про это я не сказала, потому что это как-то...
Так что	 в общем...	Так что, в общем...
То языки	 то мозги соберет там — все для внучки: любимой внучкой я была у нее.	То языки, то мозги соберет там — все для внучки: любимой внучкой я была у нее.
У меня бабушка была еще	 по	У меня бабушка была еще, по, по отцовой линии, она сторожила это, звероферму.
а	unkn	а,INTJ
аga	unkn	агатский.SLIP
ага	unkn	ага
большие	unkn	большие
бы	unkn	бы
бывают	unkn	бывают
был	unkn	был
были	unkn	были
было	unkn	было
в	unkn	в
везде	unkn	везде
веревок	unkn	веревок
взрослые	unkn	взрослые
возили	unkn	возили
вообще	unkn	вообще
восемнадцать	unkn	восемнадцать
восемь	unkn	восемь
воспитывать	RUS	воспитывать
воспитывать	unkn	воспитывать
вот	unkn	вот
время	unkn	время
все	unkn	все
всяко	unkn	всяко
всё	unkn	всё
вью	unkn	вьюки.SLIP
вьюки	unkn	вьюки
вьючиваем	unkn	вьючим
вьючим	unkn	вьючим
где	unkn	где
год	unkn	год
года	unkn	года
горб	unkn	горб
двадцати	unkn	двадцати
две	unkn	две
делать.то	unkn	делать
делают	unkn	делают
дерева	unkn	дерева
держаться	unkn	держаться
дети	unkn	дети
до	unkn	до
его	unkn	его
едем	unkn	едем
езди	unkn	SLIP
ездили	unkn	ездили
ездим	unkn	ездим
ездовая	unkn	ездовая
ездят	unkn	ездят
есть	unkn	есть
желание	unkn	желание
женщин	unkn	женщин
жизнь	unkn	жизнь
заедали	unkn	заедали
зимой	unkn	зимой
значит	unkn	значит
и	unkn	и
из	unkn	из
инмэках	unkn	инмэках
их	unkn	их
к	unkn	к
ка	unkn	каждый.SLIP
каждого	unkn	каждого
каждый	unkn	каждый
как	unkn	как
какие	unkn	какие
каникулы	unkn	каникулы
комары	unkn	комары
конец	unkn	конец
конечно	unkn	конечно
концу	unkn	концу
корочки	unkn	корочки
который	unkn	который
коч	unkn	кочевая.SLIP
кочевая	unkn	кочевая
лет	unkn	лет
летние	unkn	летние
лето	unkn	лето
летом	unkn	летом
лошади	unkn	лошади
маленький	unkn	маленький
мая	unkn	мая
места	unkn	места
месяца	unkn	месяца
мире	unkn	мире
может	unkn	может
мужской	unkn	мужской
мужчин	unkn	мужчин
мы	unkn	мы
мягким	unkn	мягким
на	unkn	на
набивают	unkn	набивают
наверно	unkn	наверно
наверное	unkn	наверное
надо	unkn	надо
назвается	unkn	назвается
называются	unkn	называются
нам	unkn	нам
например	unkn	например
нас	unkn	нас
начали	unkn	начали
нашивают	unkn	нашивают
не	unkn	не
него	unkn	него
нем	unkn	нем
нету	unkn	нету
ни	unkn	ни
ним	unkn	ним
них	unkn	них
ничего	unkn	ничего
новости	unkn	новости
новые	unkn	новые
нравилось	unkn	нравилось
нрзб	unkn	нрзб
нрзб]	unkn	нрзб]
ну	unkn	ну
общем	unkn	общем
объяснял	unkn	объяснял
обычная	unkn	обычная
одели	unkn	одели
ой	unkn	ой
оленей	unkn	оленей
оленю	unkn	оленю
он	unkn	он
они	unkn	они
опять	unkn	опять
орел.SLIP	unkn	SLIP
основном	unkn	основном
от	unkn	от
первый	unkn	первый
переведет	unkn	переведет
перемещаться	unkn	перемещаться
песни	unkn	песни
по	unkn	по
подушки	unkn	подушки
послушаем	unkn	послушаем
потом	unkn	потом
потому	unkn	потому
потяжелее	unkn	потяжелее
привил	unkn	привил
приспособления	unkn	приспособления
продукты	unkn	продукты
пятнадцать	unkn	пятнадцать
радио	unkn	радио
радиоприемникам	unkn	радиоприемникам
радиоприемников	unkn	радиоприемников
разные	unkn	разные
раньше	unkn	раньше
родовой	unkn	родовой
росли	unkn	росли
рыбаком	unkn	рыбаком
рыботочках	unkn	рыботочках
рядом	unkn	рядом
садили	unkn	садили
сами	unkn	сами
самый	unkn	самый
сверху	unkn	сверху
свои	unkn	свои
свой	unkn	свой
сейчас	unkn	сейчас
семьдесят	unkn	семьдесят
семья	unkn	семья
сентября	unkn	сентября
сидит	unkn	сидит
сказки	unkn	сказки
скользит	unkn	скользит
скользкий	unkn	скользкий
сломать	unkn	сломать
слушали	unkn	слушали
специальные	unkn	специальные
спидол	unkn	"Спидол"
спидолы	unkn	"Спидолы"
спутала	unkn	спутала
строго	unkn	строго
так	unkn	так
также	unkn	также
такие	unkn	такие
таких	unkn	таких
такой	unkn	такой
там	unkn	там
творится	unkn	творится
тоже	unkn	тоже
только	unkn	только
у	unkn	у
уже	unkn	уже
учились	unkn	учились
хорошие	unkn	хорошие
хорошо	unkn	хорошо
цепкий	unkn	цепкий
чего	unkn	чего
человек	unkn	человек
четверо	unkn	четверо
что	unkn	что
чтоб	unkn	чтоб
чтобы	unkn	чтобы
шаман???	unkn	шаман???
шестой	unkn	шестой
шкуры	unkn	шкуры
шьют	unkn	шьют
эвенков	unkn	эвенков
эти	unkn	эти
этих	unkn	этих
это	unkn	это
этот	unkn	этот
я	unkn	я
ә	unkn	SLIP,NEG,что,и
әdu	unkn	здесь
әdū	unkn	здесь
әhi	unkn	сейчас
әhī	unkn	сейчас
әjə̄	unkn	тонуть
әjә	unkn	плыть.по.течению
әkonda	unkn	Эконда
әkun	unkn	что
әliwu	unkn	стараться
әlā	unkn	сюда
әmon	unkn	оставить
әmә	unkn	прийти,SLIP
әna	unkn	она
әnini	unkn	мать
әniniw	unkn	мать.SLIP
әniәw	unkn	мать
әnu	unkn	болеть(об.органе)
әnū	unkn	болеть(об.органе)
әn…	unkn	slip
әrdәlәn	unkn	до.сих.пор
әtec	unkn	отец
әtpravilito	unkn	отправили.то
әtә	unkn	не.стать
әwenkija	unkn	Эвенкия
ә̄	unkn	INTJ
