из	unkn	Из
прамхоз	unkn	Промхоз
а	unkn	а,А
абгарā	unkn	выздороветь
аблигацэ	unkn	облигация
абратнэ	unkn	обратно
абул	unkn	отсутствовать,не.хватать
аха	unkn	гнать,женщина.PLSTEM
ахи	stem	женщина
ахи	unkn	женщина
ахӣ	unkn	женщина
аят	unkn	хорошо
акин	unkn	старший.брат
алба	stem	не.мочь
амакӣкан	unkn	вскоре
амар	unkn	зад
амари	stem	зад
амарин	unkn	оставленная.стоянка
амаски	unkn	раньше
амаскӣ	unkn	обратно
ами	unkn	отец
амин	unkn	отец
амта	unkn	почуять
амāкā	stem	дедушка
амāкā	unkn	дедушка
амӣ	unkn	отец
амӣн	unkn	отец
амнга	unkn	рот
ан	unkn	правый
ана	unkn	толкнуть
ани	unkn	они
анитэ	unkn	они.то
аннганӣ	unkn	год
аннганьӣ	unkn	год
апят	unkn	опять
араку	unkn	тихo
арки	unkn	проткнуть
аса	unkn	гнать,женщина.PLSTEM
аставляли	unkn	оставляли
атирка	stem	старуха
атирка	unkn	старуха
атиркан	stem	старуха
атиркан	unkn	старуха
ачи	unkn	NEG
анга	unkn	открыть
ангнанӣ	unkn	год
ангэ	unkn	открывать
асин	stem	NEG
асин	unkn	NEG
агā	unkn	женщина
багдама	unkn	белый
бахилай	unkn	Василий
байи	unkn	богатый
бака	stem	найти
бака	unkn	найти
бакдāкэ	stem	дикий.олень
белку	unkn	белку
бензин	unkn	бензин
бересте	unkn	береста
би	root	быть
би	stem	1SG
би	unkn	быть,1SG
билкэвали	unkn	белковали
билкэвать	unkn	белковать
бира	unkn	река
бичэвой	unkn	бечеве
бокон	unkn	догнать
болинӣ	unkn	осень
боло	unkn	настать(об.осени),осенью
болшой	unkn	большой
бочку	unkn	бочку
брали	unkn	брали
бу	stem	умереть,1PL(EXCL)
бу	unkn	умереть,дать,1pl(excl),1PL(EXCL)
букту	unkn	упасть.поскользнувшись
булта	stem	добыть
булта	unkn	добыть
бури	stem	уронить
буру	unkn	упасть
буслэ	unkn	больной
буссэ	unkn	болеть
бы	unkn	бы
был	unkn	был
были	unkn	были
былитэ	unkn	были.то
былэ	unkn	было
были	unkn	были
бē	unkn	личная.сторона
бӣ	unkn	я
бӯ	unkn	давать
бэ	unkn	быть
бэе	unkn	человек.мужчина,человек
бэльшое	unkn	большое
бэрясты	unkn	бересты
бэрэстя	unkn
бэрэстяной	unkn	берестяной
бэлес	unkn	болезнь
бэлезнь	unkn	болезнь
бидьняшкэ	unkn	бедняжка
бинзин	unkn	бензин
целэй	unkn	целый
дява	unkn	схватить
делаем	unkn	делаем
делали	unkn	делали
деп	unkn	есть
дага	stem	место.рядом
дагама	stem	приблизиться
дагама	unkn	приблизиться
даматэ	unkn	дома.то
дажэ	unkn	даже
делаюм	unkn	делаем
денег	unkn	денег
день	unkn	день
деньги	unkn	деньги
дигин	unkn	четыре
дил	unkn	голова
дили	unkn	голова
диски	unkn	в.лес
дингнилэн	unkn	бежать.галопом
до	stem	внутреннее.пространство
долбо	unkn	ночью,настать(о.ночи)
долболтоно	unkn	вечером
долди	unkn	слышать
долго	unkn	долго
долгэ	unkn	долго
долгэ	unkn	долго
донгото	stem	замерзнуть
дулин	unkn	середина
дундэ	unkn	земля
дуннэ	unkn	земля
дāр	unkn	расщепить
дāри	unkn	расщепить
дӣкэн	stem	спрятаться
дӣлэ	unkn	в.лесу
дōлди	unkn	слышать
дэ	unkn	да
дэгил	unkn	лететь
дэма	unkn	дома
дэро	unkn	исток
дэрумки	unkn	отдохнуть
дэрэ	unkn	лицо
дыли	stem	голова
дявуса	unkn	держать
делэл	unkn	делал
децэ	unkn	деться
дименьтьев	unkn	Дементьев
дименьтьеф	unkn	Дементьев
деревьне	unkn	деревня
эта	unkn	эта
эти	unkn	эти
этитэ	unkn	эти.то
этот	unkn	этот
эти	unkn	эти
ф	unkn	в
фпадают	unkn	впадают
фсех	unkn	всех
га	unkn	брать,взять
гди	unkn	где
ге	unkn	другой
гилбэни	unkn	связать.караваном
гирамна	unkn	кость
гирки	unkn	друг
гирку	unkn	ходить
гого	unkn	залаять
гоо	unkn	лаять
горо	unkn	далекий,долгое.время
город	unkn	город
горово	unkn	долго
гриша	unkn	Гриша
грус	unkn	груз
гружили	unkn	грузили
гу	stem	сказать
гу	unkn	сказать
гулу	unkn	дом
гулувун	unkn	костер
гулуча	unkn	сидеть.у.костра
гулэ	unkn	изба/дом
гун	stem	сказать
гун	unkn	сказать
гунь	unkn	говорить
гӯ	stem	сказать
гӯн	stem	сказать
гӯн	unkn	сказать
гӯнь	unkn	сказать
гэ	unkn	другой
гэдимук	unkn	затылок
гэду	unkn	году
гэлэктэ	stem	искать
гэлэктэ	unkn	искать
гэннэ	stem	забрать
гэннэ	stem	забрать
гэннэ	unkn	забрать
гэрбӣ	unkn	название
гэтовили	unkn	готовили
гэв	unkn	сделать.вторично
ха	unkn	часть
хаялэ	unkn	отсутствующий
хаки	stem	печень
хакин	stem	печень
хакя	unkn	???
халга	unkn	нога
хаман	stem	шаман
хамāн	unkn	шаман
хамāни	unkn	шаманить
ханнгукта	unkn	спросить
хавал	unkn	работать
хавали	unkn	работать
хи	unkn	2SG
хиг	unkn	ободрать
хиги	unkn	ободрать
хилба	unkn	сообщить
хин	unkn	2SG
хинэ	unkn	2SG.ACC
хитэ	unkn	пустяк
ходи	unkn
хоролгон	unkn	поляна
хоть	unkn	хоть
хоч	unkn	хоть
хонго	unkn	плакать
хую	unkn	маленький
хуе	unkn	разойтись
хукачарэф	unkn	Хукочаров
хукитэ	unkn	живот
хукти	unkn	бежать(об.олене),убежать
хукулэ	unkn	лечь
хукэ	unkn	топор
хулаки	stem	лиса
хулан	stem	Лиса
хулда	stem	одеяло
хулу	stem	нагреться(о.воздухе)
хулу	unkn	маленький
хулээн	stem	Лиса.VOC
хуру	stem	пойти
хуру	unkn	пойти
хурунэн	unkn	медведица
хутэ	stem	ребенок
хутэ	unkn	ребенок
хувул	unkn	весь
хунгни	stem	растянуть
хунгту	unkn	другой
хā	unkn	знать,часть
хēн	stem	ухо
хēрина	unkn	пойти.за.жердями
хō	unkn	сильный(о.проявлении.качества)
хōна	stem	дымовое.отверстие
хōр	unkn	задохнуться
хэгди	unkn	большой
хэктэ	unkn	постелить
хэлэ	stem	железо
хэлэ	unkn	ружье
хэну	unkn	догадаться
хэргиски	unkn	вниз
хэриву	stem	разбудить
хэрэсо	unkn	хорошо
хэнгкэт	unkn	разговаривать
и	stem	войти
и	unkn	и,войти
иду	unkn	где
иды	unkn	куда
идӯ	unkn	где
ие	unkn	рог
икту	unkn	бить
иктэ	stem	ударить
икō	unkn	петь
или	unkn	третий
ил	stem	встать
ил	unkn	встать
ила	stem	зажечь
ила	unkn	зажечь
илан	stem	три
илан	unkn	три
илани	unkn	трое
или	unkn	встать
иля	unkn	Илья
илмакта	unkn	молодой
илэ	unkn	куда
имурэ	stem	жир
ин	unkn	жить
иним	stem	навьючить
инкӣчэ	unkn	жизнь
ир	unkn	жарить
ира	unkn	Ира
ирэктэ	unkn	лиственница
ис	unkn	достичь
итти	unkn	идти
итэ	unkn	дощечка.на.дно.лодки
ичэ	stem	увидеть
ичэ	unkn	видеть,увидеть
ичэт	unkn	смотреть
ичэтчэ	unkn
инь	unkn	жить
иси	unkn	достичь
исе	unkn	видеть
я	unkn	я
йест	unkn	есть
йисть	unkn	есть
ю	stem	выйти
ю	unkn	выйти
йōкэ	unkn	кричать
ещо	unkn	еще
екэ	unkn	кричать
кактэ	unkn	как.то
калан	stem	котел
калан	unkn	котел
калхозе	unkn	колхозе
каликтивизацийи	unkn	коллективизации
калталāн	unkn	половинка.юрты
камагā	unkn	несчастье
камнӣкāс	unkn	бежать.за.зверем
капу	stem	сломать
като	unkn
каторийи	unkn	которые
каториэ	unkn	которые
качулин	unkn	шорох
канга	unkn	стругать
кем	unkn	кем
ки	unkn
кикэчи	stem	свистнуть
кино	unkn	кино
кинэмиханик	unkn	киномеханик
кирамки	unkn	острога
кинггилэ	unkn	колокольчик
клас	unkn	класс
коекак	unkn	кое.как
колхос	unkn	колхоз
колхозе	unkn	колхозе
колобо	unkn	хлеб
комната	unkn	комната
ково	unkn	кого
конги	unkn	отгрызть
конгномо	stem	черный
кто	unkn	кто
куда	unkn	куда
кукти	unkn	забраться
кулумбē	unkn	Кулюмбе
кунгака	unkn	ребенок
кунгакан	unkn	ребенок
кунгэ	unkn	ребенок
кунгэкā	unkn	ребенок
куси	unkn	биться
кӣкэ	unkn	свистеть
котуй	unkn	Котуй
кэ	unkn	INTJ
кэк	unkn	как
кэкой	unkn	какой
кэлаш	unkn	класс
кэлэ	stem	INTJ
кэлека	unkn	калека
кэргэни	unkn	семья
кэряснэярск	unkn	Красноярск
кэтэ	stem	много
кэтэ	unkn	много
кэтэ	unkn	много
кэнггилэ	unkn	колокольчик
кэкойтэ	unkn	какой.то
кинэмихник	unkn	киномеханик
лалбука	unkn	мох
лапча	unkn	рыбий.хвост
ланги	stem	распаковать
летэ	unkn	лето
летэм	unkn	летом
ли	unkn	ли
литают	unkn	летают
локо	stem	повесить
локо	unkn	повесить
лопоко	unkn	Лопоко
лу	unkn	смола
лāнг	unkn	ловушка
лэрок	unkn	ларек
ль	unkn	ль
майгу	unkn	ленок
мана	stem	закончить
мари	unkn	кустарник
медл	unkn
мигди	unkn	шуметь
мигдин	unkn	шуметь
микчāн	unkn	прыгнуть
мин	unkn	1SG
млачший	unkn	младший
много	unkn	много
мной	unkn	мной
мо	unkn	дерево
молда	stem	вырубать.доски
молда	unkn	вырубать.доски
момондо	stem	Момондо
мони	unkn	RFL
моти	stem	лось
мотор	unkn	мотор
мукэтэ	stem	задний.проход
мукэтэ	stem	задний.проход
мун	unkn	1pl.excl,1PL(EXCL)
мундука	stem	заяц
мундукан	stem	заяц
муру	unkn	обернуться
мут	unkn	1PL(INCL)
мучу	unkn	вернуться
мунгга	unkn	засмолить
мужэм	unkn	мужем
мы	unkn	мы
мāта	unkn	сосед
мēва	stem	сердце
мēван	stem	сердце
мō	unkn	дерево
мōни	unkn	RFL
мōга	unkn	лесок
мэ	unkn	RFL
мэленькэ	unkn	маленький
мэ	unkn	RFL
мэни	stem	RFL
мэни	unkn	RFL
мэнин	unkn	сам
мэван	unkn	сердце
неги	unkn	нижний
не	unkn	не
на	unkn	на
нада	unkn	семь
наи	unkn	жердь.для.остроги
нама	unkn	седло,навьючить
написывали	unkn	написывали
наптара	unkn	лечь.плашмя
нас	unkn	нас
начал	unkn	нрзб],[начал
начальник	unkn	начальник
начэвать	unkn	ночевать
не	unkn	не
нету	unkn	нет
неводить	unkn	неводить
невэдили	unkn	нéводили
невэде	unkn	невод
ни	unkn	ни,не
никэкой	unkn	никакой
ним	unkn	ним
нимнга	stem	шаманить
ниру	unkn	хариуз
ничэво	unkn	ничего
ноно	unkn	начать
ну	unkn	ну
нул	unkn	зажечь.лампу
нулги	unkn	кочевать
нулгӣ	unkn	аргишить
нурги	stem	сгореть
нурги	unkn	сгореть
нунга	unkn	3SG
нунган	stem	3SG
нунган	unkn	3SG
нунгар	unkn	3PL
нунгартин	stem	3PL
нунгартин	unkn	3PL
нунгэндӯн	unkn	3sg.datloc
нунгэнмэн	unkn	он.ACC
нō	unkn	положить
нōда	unkn	бросить
нōдā	unkn	бросать
нэ	unkn	на,положить
нэкни	unkn	младший.сиблинг.PLSTEM
нэ	unkn	положить
некудэ	unkn	некуда
ни	unkn	ни
о	stem	стать
о	unkn	стать,сделать
облигацэ	unkn	облигация
ого	unkn	срубить
ой	unkn	ой
оё	unkn	верхняя.часть,вершина
ойōкӣ	unkn	вниз.по.течению
олдо	unkn	рыба,бок
олдон	stem	крюк
олдон	unkn	бок
олло	unkn	рыба,бок
омо	unkn	оставить
он	unkn	как
оно	unkn	пойти.искать.оленей
онэ	unkn	пойти.искать.оленей
опет	stem	опять
ори	unkn	звать
оро	stem	олень
оро	unkn	олень
орон	unkn	олень
осинь	unkn	осень
онго	unkn	нос.лодки
пахэронкэ	unkn	похоронка
папал	unkn	попасть
пасёлоки	unkn	поселок
пасти	unkn	пасти
плохой	unkn	плохой
плэхой	unkn	плохой
подписывали	unkn	подписывали
порох	unkn	порох
порух	unkn	порох
прамхос	unkn	промхоз
приихэть	unkn	приехать
прожили	unkn	прожили
прожитэ	unkn	прожита
прэдуктэ	unkn	продукты
прэмхос	unkn	промхоз
прэшол	unkn	пришел
прэмхос	unkn	промхоз
приедит	unkn	приедет
пулки	stem	пуля
пура	unkn	идти.по.следу
пурух	unkn	порох
пусти	unkn	отпустить
пэ	unkn	по
пэка	unkn	пока
пэктиру	unkn	выстрелить
пэктирэ	unkn	выстрелить
пэктирэн	unkn	выстрелить
пэктирэни	stem	выстрелить.из.ружья
пэктирэнэ	stem	выстрелить.из.ружья
пэктирэ	unkn	выстрелить
пэктирэн	unkn	выстрелить
пэмэгали	unkn	помогали
пэрнишкэ	unkn	парнишка
пэруски	unkn	по.русски
пэрэпал	unkn	переполошиться
пэставить	unkn	поставить
пэтом	unkn	потом
пэтписать	unkn	подписать
пэтом	unkn	потом
пьрийедэш	unkn	приедешь
рабо	unkn
работали	unkn	работали
работать	unkn	работать
работэл	unkn	работал
расказутэ	unkn	расскажу.то
раскажу	unkn	расскажу
распался	unkn	распался
ребитишэк	unkn	ребятишек
речки	unkn	речке
рот	unkn	род
рыбак	unkn	рыбак
рыбачитьтэ	unkn	рыбачить.то
рыбачэли	unkn	рыбачили…
рыбзэвод	unkn	рыбзавод
рыбэзавот	unkn	рыбозавод
рэбятишкитэ	unkn	ребятишки.то
рэсскэжу	unkn	расскажу
речкэ	unkn	речка
рибетишкэ	unkn	ребятишки
римонтэ	unkn	ремонт,ремонта
сиринда	unkn	Чиринда
с	unkn	с
сагди	unkn	старый
салдаты	unkn	солдаты
сами	unkn	сами
самэй	unkn	самый
савецкий	unkn	советский
савода	unkn	вещь
садик	unkn	садик
си	unkn	2SG
сими	unkn	боковая.плашка.в.лодке
сколькэ	unkn	сколько
скорэ	unkn	скоро
скэнчаицэ	unkn	скончается
служ	unkn
служи	unkn	служить
со	unkn	сильный(о.проявлении.качества)
солдат	unkn	солдат
солоки	unkn	против.течения
сорэктретем	unkn	сорок.третьем
сонго	unkn	плакать
спичка	unkn	спичка
спэрватэ	unkn	сперва.то
стал	unkn	стал
стали	unkn	стали
сталэ	unkn	стало
строил	unkn	строил
строили	unkn	строили
стэиш	unkn	стоишь
судэ	unkn	ссуда
суру	unkn	пойти
сō	unkn	очень,сильный(о.проявлении.качества)
сōлӣ	unkn	солить
сэ	unkn	со
сэфхос	unkn	совхоз
сэкон	unkn	закон
сэктэ	unkn	подстилка,ветка
сэлдатэ	unkn	солдаты
сэпожникэф	unkn	Сапожников
симя	unkn	семья
сюда	unkn	сюда
та	unkn	то,тот
таду	stem	там
таду	unkn	там
тадук	stem	потом
тадук	unkn	потом
тадӯ	unkn	там
тагда	unkn	тогда
так	unkn	так
такой	unkn	такой
таку	unkn	собрать
тала	unkn	туда
талака	unkn	есть.сырым
тали	unkn
талу	unkn	береста
талӯ	unkn	береста
там	unkn	там
тама	unkn	платить
тан	unkn	курить
тар	unkn	тот
тара	unkn	тот.ACC
тардāр	unkn	?
таргит	unkn	оттуда
таргитэ	unkn	оттуда
тари	stem	тот
тари	unkn	тот,этот
тартэки	unkn	туда
тарā	unkn	этот.ACC
тарэ	stem	тот.ACC
тарэ	unkn	тот.ACC
тасит	unkn	тащит
тангу	unkn	количество
тащэм	unkn	тащим
ташим	unkn	тащим
територия	unkn	территория
ти	unkn	отпустить
тиги	unkn	подстерегать
тикчаки	unkn	Тыкчаки
тиманнэ	unkn	утром
тиматнэ	unkn	утром
тими	unkn	попасть	в	цель
тимāтнэ	unkn	утром
тин	unkn	отпустить
типерь	unkn	теперь
тирга	unkn	днем
тиргакса	unkn	пообедать
тирганӣ	unkn	день/время
тичение	unkn	течение
тингэптун	unkn	подпруга,связать.подпругой
то	unkn	то
того	stem	огонь
того	unkn	огонь
тогот	stem	лежать(о.животном)
тогочи	unkn	река.Тогочи
токто	unkn	разрубить
только	unkn	только
толгокӣ	unkn	санки
толко	unkn	только
толькэ	unkn	только
тозе	unkn	тоже
тожэ	unkn	тоже
тренин	unkn	Тренин
ту	unkn	так
туда	unkn	туда
туг	unkn	так
тугэ	unkn	туго
тугε	unkn	так
тую	stem	угощать
тук	unkn	так
тукало	stem	земля[субстанция]
тукса	unkn	убежать
тукти	unkn	залезть
тулилэ	stem	на.улице
тулилэ	unkn	на.улице
тулиски	stem	на.улицу
тулэ	unkn	поставить(капкан,ловушку)
тундру	unkn	тундру
тундры	unkn	тундры
тундрэ	unkn	тундра
тундэра	unkn	тундра
тунгуска	unkn	Тунгуска
туннга	unkn	пять
туруханскэ	unkn	Туруханске
тут	unkn	тут
тутанчани	unkn	Тутончаны
туг	unkn	так
тугэ	unkn	зимой,так
тāн	unkn	курить
тōли	unkn	тогда
тōлӣ	unkn	тогда
тэ	unkn	то
тэгэ	unkn	сесть
тэгэми	stem	завтра
тэгэминин	unkn	завтра
тэгэмӣ	unkn	завтра
тэкое	unkn	такое
тэр	unkn	этот
тэскали	unkn	таскали
тэскать	unkn	таскать
тэваришчи	unkn	товарищи
тэв	unkn	поставить
тэвэ	unkn	поймать.на.лету
тээ	unkn	сесть
тэдук	unkn	потом
тэгэ	unkn	сесть
тыгэ	stem	посуда
тыкин	stem	сейчас
тэльӣ	unkn	тогда
типерь	unkn	теперь
у	unkn	у
угла	unkn	обдирать.кору
угнали	unkn	угнали
угу	unkn	сесть.верхом
угӯ	unkn	тащить.на.себе
уй	unkn	привязать
уйи	unkn	привязать
улгучэ	unkn	рассказать
улгучэн	unkn	рассказать
ули	unkn	грести.веслами
улицэ	unkn	улице
улу	stem	белка
улу	unkn	белка
улумӣ	unkn	охотиться.на.белку
улэ	unkn	сварить,выкопать
улэ	stem	сварить
умир	unkn	умер
умно	stem	один.раз
умнэ	unkn	один.раз
умукō	unkn	один
умукōн	unkn	один
умукōн	stem	один
умукōн	unkn	один
умукэн	unkn	один
умукэн	unkn	один
умун	unkn	один
умунуктэ	unkn	вместе
умӯкэн	unkn	один
умэт	unkn	вдруг
унта	unkn	обувь
унэ	unkn	рано.утром
упкат	unkn	весь
упкачи	stem	весь
ура	stem	промахнуться
ури	stem	вытащить
уринэ	unkn	остановиться.на.однодневную.стоянку
уркэ	unkn	дверь
урā	unkn	промахнуться
урӯпчу	unkn	плохой
урэ	unkn	гора
урэ	unkn	гора
усилэ	unkn	привязать
усэ	unkn	оружие
утокогир	unkn	Утукогир
утэпили	unkn	утопили
учами	unkn	Учами
учи	unkn	учиться
училсе	unkn	учился
учит	unkn	учиться,учить
учительниц	unkn	учительница
удя	unkn	след
унг	unkn	отправить
унгкон	unkn	чашка.для.клея
унгун	unkn	этот
угиски	unkn	наверх
ва	unkn	во
ведэмэсти	unkn	ведомости
век	unkn	век
виртэлёты	unkn	вертолеты
вит	unkn
власть	unkn	власть
вот	unkn	вот
время	unkn	время
всётэки	unkn	всё.таки
выделяли	unkn	выделяли
вырэсли	unkn	выросли
выучицэ	unkn	выучиться
вышли	unkn	вышли
выжэли	unkn	выжили
вэрхнэымбаскэ	unkn	Верхнеимбатск
вэрнулис	unkn	вернулись
вэрачом	unkn	врачом
вьреме	unkn	время
ва	stem	убить
ва	unkn	убить
вакунайка	unkn	река.Вакунайка
век	unkn	век
вес	unkn	все
врач	unkn	врач
вā	stem	убить
вā	unkn	убить
вэйна	unkn	война
забэлелэ	unkn	заболела
закидываюттэ	unkn	закидывают.то
замуз	unkn	замуж
занимаси	unkn	занимать
записывайит	unkn	записывает
записывали	unkn	записывали
зарабэткэ	unkn	заработка
знаю	unkn	знаю
зэхвэтили	unkn	захватили
ā	stem	спать
ā	unkn	спать
āннгэ	unkn	ночевка
āнгнэ	unkn	ночевать
ча	unkn	чай
чагида	unkn	место.подальше
чай	unkn	чай
чалбан	unkn	береза
чат	unkn	чай
чангит	unkn	разбойник
чангити	unkn	разбойник
чинэ	unkn	густой.пучок.из.веток
чирка	unkn	чиркан
чисковой	unkn	Чисковая
чистый	unkn	чистый
чистэй	unkn	чистый
чо	unkn	что,чо
чотэ	unkn	что.то
чтоп	unkn	чтобы
чулугды	stem	Чулугды
чум	unkn	чум
чумачик	unkn	чумачик
чумэ	unkn	чума
чāски	unkn	далеко
читвёртэй	unkn	четвертый
дя	unkn	друг,родственник
дягда	stem	сосна
дяпка	unkn	берег
дяв	stem	отозваться
дяв	unkn	лодка.берестянка
ди	stem	вложить
дёни	unkn	вспомнить
дю	stem	дом.чум
дю	unkn	дом.чум
дюга	unkn	летом
дюктэ	unkn	двое
дюлэ	unkn	перед
дюма	unkn	дом.чум
дюрε	unkn	два
дьӯ	unkn	дом
дьӯр	unkn	два
деб	unkn	есть
дегди	unkn	зажечь
дели	unkn	таймень
ден	unkn	левый
деп	unkn	есть
депти	unkn	людоед
дев	stem	съесть
дев	unkn	съесть
деву	stem	съесть
ē	unkn	что
ēха	unkn	глаз
ӣ	stem	войти
ӣ	unkn	войти
ӣдӯ	unkn	где
ӣлэ	unkn	куда
ӣрги	unkn	воспитывать
нян	unkn	опять
нянгу	unkn	возражать
нихэли	unkn	распахнуть
нимнгэ	unkn	проглотить
нёгут	unkn	сначала
нюлги	unkn	кочевать
нюрма	stem	подкрасться
нюрмā	unkn	подкрасться
нюнгэн	unkn	шесть
ньāн	unkn	опять
некэ	unkn	собираться
нгалэ	unkn	рука
нги	unkn	кто
нгинаки	unkn	собака
нгинакин	unkn	собака
нгэлэ	unkn	испугаться
нгэну	unkn	возвращаться
нгэнэ	unkn	идти
нгэлэ	unkn	испугать
нгэски	unkn	вниз.по.склону
ō	unkn	сделать,делать,стать
ōн	unkn	как
ōнг	unkn	как
сила	unkn	жарить.на.вертеле
симка	stem	срединная.жердь
сюлугди	stem	Чулугды
сюлугди	unkn	Чулугды
сюлугды	stem	Чулугды
щото	unkn	что.то
школа	unkn	школа
штобы	unkn	чтобы
ӯча	unkn	ездить.верхом
ӯчак	unkn	верховой	олень
ӯчаки	unkn	верховой	олень
же	unkn	же
жили	unkn	жили
жизьнь	unkn	жизнь
жэ	unkn	же
зэн	unkn	забыть
э	unkn	а,NEG,что,да,neg
эбэйкэкӯн	unkn	очень.страшный
эда	stem	зачем
эди	unkn	муж
эдин	unkn	один
эдук	unkn	отсюда
эдӯ	unkn	теперь,здесь,там
эха	unkn	глаз
эхи	stem	сейчас
эхи	unkn	сейчас
эхӣ	unkn	сейчас
эйӣ	unkn	утонуть
эе	unkn	утонуть
эе	unkn	утонуть
эет	unkn	просить
эл	unkn	эй
эличэпил	unkn	?
элэ	unkn	весь
элэ	unkn	основной
эмнгэнги	unkn	вместительный
эмэ	stem	прийти
эмэ	unkn	приходить,прийти
эмэн	unkn	оставить
энтил	unkn	родитель.PL
энтыл	stem	родитель.PL
эни	unkn	мать
энӣн	unkn	мать
эптилэ	stem	ребро
эптилэ	unkn	ребро
эпеть	unkn	опять
эр	stem	звать
эр	unkn	вот,этот
эркэмэю	unkn	место.почти.здесь
эрупчу	unkn	плохой
эрӣ	unkn	дышать
эрε	unkn	здесь
эсӣ	unkn	сегодня,сейчас
эт	unkn
эти	unkn	эти
этирко	unkn	старик
этиркōн	unkn	муж
этиркō	unkn	старик
этиркōни	unkn	старик
этиркэ	unkn	старик
этиркэн	stem	старик
этиркэн	unkn	старик
этиркэни	stem	старик
этки	unkn	свекор
это	unkn	это
этпрэвляют	unkn	отправляют
этпрэвляли	unkn	отправили
этэ	unkn	не.стать
эвус	unkn	спуститься
эвэды	unkn	эвенкийский
эвэдыт	unkn	эвенкийский
эди	unkn	низовье
энин	unkn	мать
эньӣ	unkn	мать
эньӣн	unkn	мать
эщо	unkn	еще
э	unkn	этот,что
экӯн	unkn	кто/что,что
элаха	unkn	всегда/в.какой.период
эри	stem	звать
эри	unkn	звать
эт	unkn	чем
эгӣ	unkn	сейчас
гришэ	unkn	Гриша
эдӯ	unkn	здесь
эн	unkn
эна	unkn	она
этец	unkn	отец
этправилито	unkn	отправили.то
